Match ID,Team X,Team Y,Team A,Team B,Map Name,Team X Score,Team Y Score,Team X Attack Rounds,Team X Defense Rounds,Team X Overtime Rounds,Team Y Attack Rounds,Team Y Defense Rounds,Team Y Overtime Rounds,Map Index,Side Picker,Side Picked,Overtime,Map Winner,Score Difference,Total Rounds Played,Map Picker,Team X Halftime Score,Team Y Halftime Score,Halftime Lead
1,NRG Esports,KOI,NRG Esports,KOI,Icebox,13,11,10,3,0,9,2,0,1,KOI,Attack,0,NRG Esports,2,24,NRG Esports,3,9,-6
1,KOI,NRG Esports,NRG Esports,KOI,Haven,9,13,5,4,0,8,5,0,2,NRG Esports,Attack,0,NRG Esports,-4,22,KOI,4,8,-4
2,DetonatioN FocusMe,GIANTX,DetonatioN FocusMe,GIANTX,Haven,4,13,4,0,0,5,8,0,1,GIANTX,Defense,0,GIANTX,-9,17,DetonatioN FocusMe,4,8,-4
2,GIANTX,DetonatioN FocusMe,DetonatioN FocusMe,GIANTX,Icebox,13,7,8,5,0,3,4,0,2,DetonatioN FocusMe,Defense,0,GIANTX,6,20,GIANTX,8,4,4
3,FunPlus Phoenix,Karmine Corp,FunPlus Phoenix,Karmine Corp,Lotus,6,13,4,2,0,5,8,0,1,Karmine Corp,Defense,0,Karmine Corp,-7,19,FunPlus Phoenix,4,8,-4
3,Karmine Corp,FunPlus Phoenix,FunPlus Phoenix,Karmine Corp,Haven,8,13,6,2,0,7,6,0,2,FunPlus Phoenix,Defense,0,FunPlus Phoenix,-5,21,Karmine Corp,6,6,0
3,Karmine Corp,FunPlus Phoenix,FunPlus Phoenix,Karmine Corp,Pearl,13,6,7,6,0,1,5,0,3,FunPlus Phoenix,Defense,0,Karmine Corp,7,19,,7,5,2
4,DRX,BBL Esports,DRX,BBL Esports,Pearl,13,3,9,4,0,0,3,0,1,BBL Esports,Defense,0,DRX,10,16,DRX,9,3,6
4,BBL Esports,DRX,DRX,BBL Esports,Ascent,13,11,4,9,0,3,8,0,2,DRX,Defense,0,BBL Esports,2,24,BBL Esports,4,8,-4
4,BBL Esports,DRX,DRX,BBL Esports,Haven,7,13,6,1,0,11,2,0,3,DRX,Attack,0,DRX,-6,20,,1,11,-10
5,Paper Rex,Cloud9,Paper Rex,Cloud9,Lotus,8,13,5,3,0,6,7,0,1,Cloud9,Defense,0,Cloud9,-5,21,Paper Rex,5,7,-2
5,Cloud9,Paper Rex,Paper Rex,Cloud9,Pearl,13,4,10,3,0,2,2,0,2,Paper Rex,Defense,0,Cloud9,9,17,Cloud9,10,2,8
6,Evil Geniuses,Team Heretics,Evil Geniuses,Team Heretics,Pearl,13,8,6,7,0,2,6,0,1,Team Heretics,Defense,0,Evil Geniuses,5,21,Evil Geniuses,6,6,0
6,Team Heretics,Evil Geniuses,Evil Geniuses,Team Heretics,Ascent,8,13,5,3,0,6,7,0,2,Evil Geniuses,Defense,0,Evil Geniuses,-5,21,Team Heretics,5,7,-2
7,MIBR,TALON,MIBR,TALON,Haven,8,13,4,4,0,5,8,0,1,TALON,Defense,0,TALON,-5,21,MIBR,4,8,-4
7,TALON,MIBR,MIBR,TALON,Fracture,13,11,6,7,0,5,6,0,2,MIBR,Attack,0,TALON,2,24,TALON,7,5,2
8,LOUD,Gen.G,LOUD,Gen.G,Pearl,13,9,8,5,0,7,2,0,1,Gen.G,Attack,0,LOUD,4,22,LOUD,5,7,-2
8,Gen.G,LOUD,LOUD,Gen.G,Fracture,12,14,8,4,0,8,4,2,2,LOUD,Attack,1,LOUD,-2,26,Gen.G,4,8,-4
9,NRG Esports,GIANTX,NRG Esports,GIANTX,Lotus,12,14,8,4,0,8,4,2,1,GIANTX,Attack,1,GIANTX,-2,26,NRG Esports,4,8,-4
9,GIANTX,NRG Esports,NRG Esports,GIANTX,Haven,1,13,0,1,0,11,2,0,2,NRG Esports,Attack,0,NRG Esports,-12,14,GIANTX,1,11,-10
9,GIANTX,NRG Esports,NRG Esports,GIANTX,Icebox,7,13,3,4,0,4,9,0,3,NRG Esports,Defense,0,NRG Esports,-6,20,,3,9,-6
10,LOUD,Karmine Corp,LOUD,Karmine Corp,Pearl,13,10,8,5,0,6,4,0,1,Karmine Corp,Defense,0,LOUD,3,23,LOUD,8,4,4
10,Karmine Corp,LOUD,LOUD,Karmine Corp,Split,8,13,4,4,0,8,5,0,2,LOUD,Attack,0,LOUD,-5,21,Karmine Corp,4,8,-4
11,Cloud9,DRX,Cloud9,DRX,Pearl,13,3,4,9,0,3,0,0,1,DRX,Attack,0,Cloud9,10,16,Cloud9,9,3,6
11,DRX,Cloud9,Cloud9,DRX,Haven,13,7,9,4,0,4,3,0,2,Cloud9,Defense,0,DRX,6,20,DRX,9,3,6
11,DRX,Cloud9,Cloud9,DRX,Icebox,13,2,11,2,0,1,1,0,3,Cloud9,Defense,0,DRX,11,15,,11,1,10
12,Evil Geniuses,TALON,Evil Geniuses,TALON,Haven,11,13,2,9,0,3,10,0,1,TALON,Attack,0,TALON,-2,24,Evil Geniuses,9,3,6
12,TALON,Evil Geniuses,Evil Geniuses,TALON,Split,13,10,4,9,0,2,8,0,2,Evil Geniuses,Defense,0,TALON,3,23,TALON,4,8,-4
13,NRG Esports,LOUD,NRG Esports,LOUD,Split,3,13,0,3,0,9,4,0,1,LOUD,Attack,0,LOUD,-10,16,NRG Esports,3,9,-6
13,LOUD,NRG Esports,NRG Esports,LOUD,Pearl,13,15,7,5,1,7,5,3,2,NRG Esports,Attack,1,NRG Esports,-2,28,LOUD,5,7,-2
13,LOUD,NRG Esports,NRG Esports,LOUD,Fracture,18,16,7,5,6,7,5,4,3,NRG Esports,Defense,1,LOUD,2,34,,7,5,2
14,TALON,DRX,TALON,DRX,Fracture,13,10,5,8,0,4,6,0,1,DRX,Attack,0,TALON,3,23,TALON,8,4,4
14,DRX,TALON,TALON,DRX,Ascent,13,6,6,7,0,0,6,0,2,TALON,Defense,0,DRX,7,19,DRX,6,6,0
14,DRX,TALON,TALON,DRX,Icebox,13,10,7,6,0,5,5,0,3,TALON,Defense,0,DRX,3,23,,7,5,2
15,Team Secret,Team Liquid,Team Secret,Team Liquid,Icebox,13,8,3,10,0,2,6,0,1,Team Liquid,Attack,0,Team Secret,5,21,Team Secret,10,2,8
15,Team Liquid,Team Secret,Team Secret,Team Liquid,Fracture,7,13,3,4,0,4,9,0,2,Team Secret,Defense,0,Team Secret,-6,20,Team Liquid,3,9,-6
16,KRÜ Esports,Natus Vincere,KRÜ Esports,Natus Vincere,Ascent,5,13,2,3,0,9,4,0,1,Natus Vincere,Attack,0,Natus Vincere,-8,18,KRÜ Esports,3,9,-6
16,Natus Vincere,KRÜ Esports,KRÜ Esports,Natus Vincere,Lotus,13,10,10,3,0,9,1,0,2,KRÜ Esports,Attack,0,Natus Vincere,3,23,Natus Vincere,3,9,-6
17,LEVIATÁN,ZETA DIVISION,LEVIATÁN,ZETA DIVISION,Ascent,13,4,10,3,0,2,2,0,1,ZETA DIVISION,Defense,0,LEVIATÁN,9,17,LEVIATÁN,10,2,8
17,ZETA DIVISION,LEVIATÁN,LEVIATÁN,ZETA DIVISION,Pearl,11,13,6,5,0,7,6,0,2,LEVIATÁN,Defense,0,LEVIATÁN,-2,24,ZETA DIVISION,6,6,0
18,Global Esports,Team Vitality,Global Esports,Team Vitality,Split,4,13,1,3,0,9,4,0,1,Team Vitality,Attack,0,Team Vitality,-9,17,Global Esports,3,9,-6
18,Team Vitality,Global Esports,Global Esports,Team Vitality,Pearl,9,13,2,7,0,5,8,0,2,Global Esports,Attack,0,Global Esports,-4,22,Team Vitality,7,5,2
18,Team Vitality,Global Esports,Global Esports,Team Vitality,Lotus,13,6,8,5,0,2,4,0,3,Global Esports,Defense,0,Team Vitality,7,19,,8,4,4
19,Rex Regum Qeon,FUT Esports,Rex Regum Qeon,FUT Esports,Lotus,3,13,2,1,0,3,10,0,1,FUT Esports,Defense,0,FUT Esports,-10,16,Rex Regum Qeon,2,10,-8
19,FUT Esports,Rex Regum Qeon,Rex Regum Qeon,FUT Esports,Pearl,13,11,8,5,0,7,4,0,2,Rex Regum Qeon,Attack,0,FUT Esports,2,24,FUT Esports,5,7,-2
20,100 Thieves,EDward Gaming,100 Thieves,EDward Gaming,Icebox,13,10,5,8,0,4,6,0,1,EDward Gaming,Attack,0,100 Thieves,3,23,100 Thieves,8,4,4
20,EDward Gaming,100 Thieves,100 Thieves,EDward Gaming,Lotus,13,9,8,5,0,7,2,0,2,100 Thieves,Attack,0,EDward Gaming,4,22,EDward Gaming,5,7,-2
20,EDward Gaming,100 Thieves,100 Thieves,EDward Gaming,Pearl,12,14,5,7,0,5,7,2,3,100 Thieves,Attack,1,100 Thieves,-2,26,,7,5,2
21,FNATIC,Sentinels,FNATIC,Sentinels,Haven,13,6,4,9,0,3,3,0,1,Sentinels,Attack,0,FNATIC,7,19,FNATIC,9,3,6
21,Sentinels,FNATIC,FNATIC,Sentinels,Split,7,13,6,1,0,7,6,0,2,FNATIC,Defense,0,FNATIC,-6,20,Sentinels,6,6,0
22,T1,FURIA,T1,FURIA,Pearl,7,13,1,6,0,6,7,0,1,FURIA,Attack,0,FURIA,-6,20,T1,6,6,0
22,FURIA,T1,T1,FURIA,Icebox,13,5,6,7,0,5,0,0,2,T1,Attack,0,FURIA,8,18,FURIA,7,5,2
23,Team Secret,Natus Vincere,Team Secret,Natus Vincere,Icebox,8,13,6,2,0,7,6,0,1,Natus Vincere,Defense,0,Natus Vincere,-5,21,Team Secret,6,6,0
23,Natus Vincere,Team Secret,Team Secret,Natus Vincere,Pearl,13,4,4,9,0,3,1,0,2,Team Secret,Attack,0,Natus Vincere,9,17,Natus Vincere,9,3,6
24,LEVIATÁN,Team Vitality,LEVIATÁN,Team Vitality,Haven,16,14,7,5,4,7,5,2,1,Team Vitality,Attack,1,LEVIATÁN,2,30,LEVIATÁN,5,7,-2
24,Team Vitality,LEVIATÁN,LEVIATÁN,Team Vitality,Pearl,3,13,2,1,0,3,10,0,2,LEVIATÁN,Defense,0,LEVIATÁN,-10,16,Team Vitality,2,10,-8
25,FUT Esports,100 Thieves,FUT Esports,100 Thieves,Lotus,13,9,8,5,0,7,2,0,1,100 Thieves,Attack,0,FUT Esports,4,22,FUT Esports,5,7,-2
25,100 Thieves,FUT Esports,FUT Esports,100 Thieves,Haven,13,11,7,6,0,6,5,0,2,FUT Esports,Defense,0,100 Thieves,2,24,100 Thieves,7,5,2
25,100 Thieves,FUT Esports,FUT Esports,100 Thieves,Icebox,13,8,5,8,0,4,4,0,3,FUT Esports,Attack,0,100 Thieves,5,21,,8,4,4
26,FNATIC,FURIA,FNATIC,FURIA,Haven,18,16,8,4,6,8,4,4,1,FURIA,Defense,1,FNATIC,2,34,FNATIC,8,4,4
26,FURIA,FNATIC,FNATIC,FURIA,Ascent,9,13,4,5,0,5,8,0,2,FNATIC,Defense,0,FNATIC,-4,22,FURIA,4,8,-4
27,LEVIATÁN,Natus Vincere,LEVIATÁN,Natus Vincere,Ascent,10,13,6,4,0,7,6,0,1,Natus Vincere,Defense,0,Natus Vincere,-3,23,LEVIATÁN,6,6,0
27,Natus Vincere,LEVIATÁN,LEVIATÁN,Natus Vincere,Fracture,13,2,11,2,0,1,1,0,2,LEVIATÁN,Defense,0,Natus Vincere,11,15,Natus Vincere,11,1,10
28,100 Thieves,FNATIC,100 Thieves,FNATIC,Fracture,1,13,0,1,0,11,2,0,1,FNATIC,Attack,0,FNATIC,-12,14,100 Thieves,1,11,-10
28,FNATIC,100 Thieves,100 Thieves,FNATIC,Icebox,13,10,3,10,0,2,8,0,2,100 Thieves,Attack,0,FNATIC,3,23,FNATIC,10,2,8
29,LOUD,DRX,LOUD,DRX,Pearl,13,5,4,9,0,3,2,0,1,DRX,Attack,0,LOUD,8,18,LOUD,9,3,6
29,DRX,LOUD,LOUD,DRX,Icebox,8,13,5,3,0,9,4,0,2,LOUD,Attack,0,LOUD,-5,21,DRX,3,9,-6
29,LOUD,DRX,LOUD,DRX,Split,7,13,3,4,0,4,9,0,3,DRX,Defense,0,DRX,-6,20,LOUD,3,9,-6
29,DRX,LOUD,LOUD,DRX,Fracture,13,7,7,6,0,6,1,0,4,LOUD,Attack,0,DRX,6,20,DRX,6,6,0
29,LOUD,DRX,LOUD,DRX,Ascent,13,8,7,6,0,3,5,0,5,DRX,Defense,0,LOUD,5,21,,7,5,2
30,FNATIC,Natus Vincere,FNATIC,Natus Vincere,Haven,13,11,6,7,0,5,6,0,1,Natus Vincere,Attack,0,FNATIC,2,24,FNATIC,7,5,2
30,Natus Vincere,FNATIC,FNATIC,Natus Vincere,Lotus,4,13,2,2,0,10,3,0,2,FNATIC,Attack,0,FNATIC,-9,17,Natus Vincere,2,10,-8
30,FNATIC,Natus Vincere,FNATIC,Natus Vincere,Fracture,13,11,6,7,0,5,6,0,3,Natus Vincere,Defense,0,FNATIC,2,24,FNATIC,6,6,0
31,LOUD,FNATIC,LOUD,FNATIC,Ascent,8,13,4,4,0,5,8,0,1,FNATIC,Defense,0,FNATIC,-5,21,LOUD,4,8,-4
31,FNATIC,LOUD,LOUD,FNATIC,Fracture,13,7,6,7,0,1,6,0,2,LOUD,Defense,0,FNATIC,6,20,FNATIC,6,6,0
31,LOUD,FNATIC,LOUD,FNATIC,Split,13,9,7,6,0,4,5,0,3,FNATIC,Defense,0,LOUD,4,22,LOUD,7,5,2
31,FNATIC,LOUD,LOUD,FNATIC,Lotus,8,13,3,5,0,7,6,0,4,LOUD,Attack,0,LOUD,-5,21,FNATIC,5,7,-2
31,LOUD,FNATIC,LOUD,FNATIC,Icebox,12,14,9,3,0,9,3,2,5,FNATIC,Defense,1,FNATIC,-2,26,,9,3,6
32,DRX,ZETA DIVISION,DRX,ZETA DIVISION,Ascent,13,5,8,5,0,1,4,0,1,ZETA DIVISION,Defense,0,DRX,8,18,DRX,8,4,4
32,ZETA DIVISION,DRX,DRX,ZETA DIVISION,Pearl,5,13,4,1,0,11,2,0,2,DRX,Attack,0,DRX,-8,18,ZETA DIVISION,1,11,-10
33,Global Esports,T1,Global Esports,T1,Pearl,8,13,3,5,0,4,9,0,1,T1,Defense,0,T1,-5,21,Global Esports,3,9,-6
33,T1,Global Esports,Global Esports,T1,Haven,4,13,2,2,0,10,3,0,2,Global Esports,Attack,0,Global Esports,-9,17,T1,2,10,-8
33,T1,Global Esports,Global Esports,T1,Lotus,13,7,5,8,0,4,3,0,3,Global Esports,Attack,0,T1,6,20,,8,4,4
34,Paper Rex,DetonatioN FocusMe,Paper Rex,DetonatioN FocusMe,Pearl,13,5,4,9,0,3,2,0,1,DetonatioN FocusMe,Attack,0,Paper Rex,8,18,Paper Rex,9,3,6
34,DetonatioN FocusMe,Paper Rex,Paper Rex,DetonatioN FocusMe,Lotus,11,13,6,5,0,7,6,0,2,Paper Rex,Attack,0,Paper Rex,-2,24,DetonatioN FocusMe,5,7,-2
35,TALON,Team Secret,TALON,Team Secret,Ascent,5,13,4,1,0,5,8,0,1,Team Secret,Defense,0,Team Secret,-8,18,TALON,4,8,-4
35,Team Secret,TALON,TALON,Team Secret,Icebox,8,13,3,5,0,4,9,0,2,TALON,Defense,0,TALON,-5,21,Team Secret,3,9,-6
35,Team Secret,TALON,TALON,Team Secret,Fracture,13,3,10,3,0,1,2,0,3,TALON,Defense,0,Team Secret,10,16,,10,2,8
36,Gen.G,Rex Regum Qeon,Gen.G,Rex Regum Qeon,Fracture,13,9,8,5,0,5,4,0,1,Rex Regum Qeon,Defense,0,Gen.G,4,22,Gen.G,8,4,4
36,Rex Regum Qeon,Gen.G,Gen.G,Rex Regum Qeon,Lotus,6,13,2,4,0,8,5,0,2,Gen.G,Attack,0,Gen.G,-7,19,Rex Regum Qeon,4,8,-4
37,ZETA DIVISION,Rex Regum Qeon,ZETA DIVISION,Rex Regum Qeon,Haven,10,13,3,7,0,4,9,0,1,Rex Regum Qeon,Defense,0,Rex Regum Qeon,-3,23,ZETA DIVISION,3,9,-6
37,Rex Regum Qeon,ZETA DIVISION,ZETA DIVISION,Rex Regum Qeon,Ascent,10,13,4,6,0,6,7,0,2,ZETA DIVISION,Attack,0,ZETA DIVISION,-3,23,Rex Regum Qeon,6,6,0
37,Rex Regum Qeon,ZETA DIVISION,ZETA DIVISION,Rex Regum Qeon,Lotus,5,13,0,5,0,7,6,0,3,ZETA DIVISION,Attack,0,ZETA DIVISION,-8,18,,5,7,-2
38,T1,TALON,T1,TALON,Ascent,13,8,8,5,0,4,4,0,1,TALON,Defense,0,T1,5,21,T1,8,4,4
38,TALON,T1,T1,TALON,Haven,6,13,3,3,0,9,4,0,2,T1,Attack,0,T1,-7,19,TALON,3,9,-6
39,Team Secret,Paper Rex,Team Secret,Paper Rex,Haven,11,13,5,6,0,6,7,0,1,Paper Rex,Attack,0,Paper Rex,-2,24,Team Secret,6,6,0
39,Paper Rex,Team Secret,Team Secret,Paper Rex,Fracture,11,13,4,7,0,5,8,0,2,Team Secret,Defense,0,Team Secret,-2,24,Paper Rex,4,8,-4
39,Paper Rex,Team Secret,Team Secret,Paper Rex,Split,10,13,7,3,0,8,5,0,3,Team Secret,Defense,0,Team Secret,-3,23,,7,5,2
40,DetonatioN FocusMe,Gen.G,DetonatioN FocusMe,Gen.G,Lotus,8,13,1,7,0,5,8,0,1,Gen.G,Attack,0,Gen.G,-5,21,DetonatioN FocusMe,7,5,2
40,Gen.G,DetonatioN FocusMe,DetonatioN FocusMe,Gen.G,Fracture,4,13,0,4,0,8,5,0,2,DetonatioN FocusMe,Attack,0,DetonatioN FocusMe,-9,17,Gen.G,4,8,-4
40,Gen.G,DetonatioN FocusMe,DetonatioN FocusMe,Gen.G,Pearl,13,8,8,5,0,7,1,0,3,DetonatioN FocusMe,Attack,0,Gen.G,5,21,,5,7,-2
41,DRX,Global Esports,DRX,Global Esports,Haven,13,11,6,7,0,5,6,0,1,Global Esports,Attack,0,DRX,2,24,DRX,7,5,2
41,Global Esports,DRX,DRX,Global Esports,Split,15,17,6,6,3,6,6,5,2,DRX,Defense,1,DRX,-2,32,Global Esports,6,6,0
42,Rex Regum Qeon,DetonatioN FocusMe,Rex Regum Qeon,DetonatioN FocusMe,Haven,13,4,3,10,0,2,2,0,1,DetonatioN FocusMe,Attack,0,Rex Regum Qeon,9,17,Rex Regum Qeon,10,2,8
42,DetonatioN FocusMe,Rex Regum Qeon,Rex Regum Qeon,DetonatioN FocusMe,Pearl,7,13,3,4,0,4,9,0,2,Rex Regum Qeon,Defense,0,Rex Regum Qeon,-6,20,DetonatioN FocusMe,3,9,-6
43,T1,Paper Rex,T1,Paper Rex,Pearl,3,13,2,1,0,11,2,0,1,Paper Rex,Attack,0,Paper Rex,-10,16,T1,1,11,-10
43,Paper Rex,T1,T1,Paper Rex,Fracture,13,6,7,6,0,1,5,0,2,T1,Defense,0,Paper Rex,7,19,Paper Rex,7,5,2
44,Global Esports,ZETA DIVISION,Global Esports,ZETA DIVISION,Pearl,13,9,4,9,0,3,6,0,1,ZETA DIVISION,Attack,0,Global Esports,4,22,Global Esports,9,3,6
44,ZETA DIVISION,Global Esports,Global Esports,ZETA DIVISION,Ascent,14,12,5,7,2,5,7,0,2,Global Esports,Defense,1,ZETA DIVISION,2,26,ZETA DIVISION,5,7,-2
44,ZETA DIVISION,Global Esports,Global Esports,ZETA DIVISION,Haven,13,8,5,8,0,4,4,0,3,Global Esports,Attack,0,ZETA DIVISION,5,21,,8,4,4
45,TALON,DRX,TALON,DRX,Split,3,13,1,2,0,2,11,0,1,DRX,Defense,0,DRX,-10,16,TALON,1,11,-10
45,DRX,TALON,TALON,DRX,Pearl,13,10,6,7,0,5,5,0,2,TALON,Attack,0,DRX,3,23,DRX,7,5,2
46,Gen.G,Team Secret,Gen.G,Team Secret,Haven,13,8,7,6,0,3,5,0,1,Team Secret,Defense,0,Gen.G,5,21,Gen.G,7,5,2
46,Team Secret,Gen.G,Gen.G,Team Secret,Fracture,11,13,5,6,0,6,7,0,2,Gen.G,Attack,0,Gen.G,-2,24,Team Secret,6,6,0
47,DRX,Paper Rex,DRX,Paper Rex,Ascent,13,5,9,4,0,2,3,0,1,Paper Rex,Defense,0,DRX,8,18,DRX,9,3,6
47,Paper Rex,DRX,DRX,Paper Rex,Split,10,13,5,5,0,6,7,0,2,DRX,Defense,0,DRX,-3,23,Paper Rex,5,7,-2
48,Team Secret,Rex Regum Qeon,Team Secret,Rex Regum Qeon,Icebox,10,13,5,5,0,6,7,0,1,Rex Regum Qeon,Defense,0,Rex Regum Qeon,-3,23,Team Secret,5,7,-2
48,Rex Regum Qeon,Team Secret,Team Secret,Rex Regum Qeon,Split,13,7,10,3,0,5,2,0,2,Team Secret,Defense,0,Rex Regum Qeon,6,20,Rex Regum Qeon,10,2,8
49,T1,Gen.G,T1,Gen.G,Ascent,5,13,3,2,0,4,9,0,1,Gen.G,Defense,0,Gen.G,-8,18,T1,3,9,-6
49,Gen.G,T1,T1,Gen.G,Haven,13,5,7,6,0,0,5,0,2,T1,Defense,0,Gen.G,8,18,Gen.G,7,5,2
50,ZETA DIVISION,DetonatioN FocusMe,ZETA DIVISION,DetonatioN FocusMe,Ascent,13,9,10,3,0,7,2,0,1,DetonatioN FocusMe,Defense,0,ZETA DIVISION,4,22,ZETA DIVISION,10,2,8
50,DetonatioN FocusMe,ZETA DIVISION,ZETA DIVISION,DetonatioN FocusMe,Haven,5,13,2,3,0,9,4,0,2,ZETA DIVISION,Attack,0,ZETA DIVISION,-8,18,DetonatioN FocusMe,3,9,-6
51,Global Esports,TALON,Global Esports,TALON,Split,13,6,4,9,0,3,3,0,1,TALON,Attack,0,Global Esports,7,19,Global Esports,9,3,6
51,TALON,Global Esports,Global Esports,TALON,Icebox,11,13,6,5,0,7,6,0,2,Global Esports,Defense,0,Global Esports,-2,24,TALON,6,6,0
52,Paper Rex,Global Esports,Paper Rex,Global Esports,Icebox,7,13,6,1,0,7,6,0,1,Global Esports,Defense,0,Global Esports,-6,20,Paper Rex,6,6,0
52,Global Esports,Paper Rex,Paper Rex,Global Esports,Split,6,13,3,3,0,9,4,0,2,Paper Rex,Attack,0,Paper Rex,-7,19,Global Esports,3,9,-6
52,Global Esports,Paper Rex,Paper Rex,Global Esports,Pearl,7,13,3,4,0,8,5,0,3,Paper Rex,Attack,0,Paper Rex,-6,20,,4,8,-4
53,Gen.G,DRX,Gen.G,DRX,Haven,7,13,6,1,0,11,2,0,1,DRX,Attack,0,DRX,-6,20,Gen.G,1,11,-10
53,DRX,Gen.G,Gen.G,DRX,Fracture,10,13,4,6,0,6,7,0,2,Gen.G,Attack,0,Gen.G,-3,23,DRX,6,6,0
53,DRX,Gen.G,Gen.G,DRX,Pearl,13,4,4,9,0,3,1,0,3,Gen.G,Attack,0,DRX,9,17,,9,3,6
54,Rex Regum Qeon,T1,Rex Regum Qeon,T1,Haven,9,13,4,5,0,7,6,0,1,T1,Attack,0,T1,-4,22,Rex Regum Qeon,5,7,-2
54,T1,Rex Regum Qeon,Rex Regum Qeon,T1,Fracture,13,4,9,4,0,1,3,0,2,Rex Regum Qeon,Defense,0,T1,9,17,T1,9,3,6
55,DetonatioN FocusMe,Team Secret,DetonatioN FocusMe,Team Secret,Ascent,11,13,5,6,0,6,7,0,1,Team Secret,Attack,0,Team Secret,-2,24,DetonatioN FocusMe,6,6,0
55,Team Secret,DetonatioN FocusMe,DetonatioN FocusMe,Team Secret,Haven,13,8,4,9,0,3,5,0,2,DetonatioN FocusMe,Attack,0,Team Secret,5,21,Team Secret,9,3,6
56,TALON,ZETA DIVISION,TALON,ZETA DIVISION,Haven,13,8,5,8,0,4,4,0,1,ZETA DIVISION,Attack,0,TALON,5,21,TALON,8,4,4
56,ZETA DIVISION,TALON,TALON,ZETA DIVISION,Ascent,14,16,6,6,2,6,6,4,2,TALON,Attack,1,TALON,-2,30,ZETA DIVISION,6,6,0
57,T1,DetonatioN FocusMe,T1,DetonatioN FocusMe,Lotus,13,9,6,7,0,5,4,0,1,DetonatioN FocusMe,Attack,0,T1,4,22,T1,7,5,2
57,DetonatioN FocusMe,T1,T1,DetonatioN FocusMe,Split,13,9,7,6,0,4,5,0,2,T1,Defense,0,DetonatioN FocusMe,4,22,DetonatioN FocusMe,7,5,2
57,DetonatioN FocusMe,T1,T1,DetonatioN FocusMe,Fracture,10,13,4,6,0,6,7,0,3,T1,Attack,0,T1,-3,23,,6,6,0
58,ZETA DIVISION,Team Secret,ZETA DIVISION,Team Secret,Split,13,9,8,5,0,5,4,0,1,Team Secret,Defense,0,ZETA DIVISION,4,22,ZETA DIVISION,8,4,4
58,Team Secret,ZETA DIVISION,ZETA DIVISION,Team Secret,Lotus,13,10,7,6,0,6,4,0,2,ZETA DIVISION,Attack,0,Team Secret,3,23,Team Secret,6,6,0
58,Team Secret,ZETA DIVISION,ZETA DIVISION,Team Secret,Fracture,9,13,4,5,0,7,6,0,3,ZETA DIVISION,Attack,0,ZETA DIVISION,-4,22,,5,7,-2
59,Global Esports,Gen.G,Global Esports,Gen.G,Pearl,13,8,8,5,0,7,1,0,1,Gen.G,Attack,0,Global Esports,5,21,Global Esports,5,7,-2
59,Gen.G,Global Esports,Global Esports,Gen.G,Lotus,8,13,3,5,0,7,6,0,2,Global Esports,Attack,0,Global Esports,-5,21,Gen.G,5,7,-2
60,DRX,Rex Regum Qeon,DRX,Rex Regum Qeon,Haven,8,13,2,6,0,6,7,0,1,Rex Regum Qeon,Attack,0,Rex Regum Qeon,-5,21,DRX,6,6,0
60,Rex Regum Qeon,DRX,DRX,Rex Regum Qeon,Split,10,13,6,4,0,7,6,0,2,DRX,Defense,0,DRX,-3,23,Rex Regum Qeon,6,6,0
60,Rex Regum Qeon,DRX,DRX,Rex Regum Qeon,Pearl,2,13,0,2,0,10,3,0,3,DRX,Attack,0,DRX,-11,15,,2,10,-8
61,TALON,Paper Rex,TALON,Paper Rex,Pearl,13,11,9,4,0,8,3,0,1,Paper Rex,Attack,0,TALON,2,24,TALON,4,8,-4
61,Paper Rex,TALON,TALON,Paper Rex,Split,13,4,4,9,0,3,1,0,2,TALON,Attack,0,Paper Rex,9,17,Paper Rex,9,3,6
61,Paper Rex,TALON,TALON,Paper Rex,Fracture,13,10,7,6,0,6,4,0,3,TALON,Attack,0,Paper Rex,3,23,,6,6,0
62,Gen.G,TALON,Gen.G,TALON,Fracture,8,13,3,5,0,7,6,0,1,TALON,Attack,0,TALON,-5,21,Gen.G,5,7,-2
62,TALON,Gen.G,Gen.G,TALON,Lotus,13,7,6,7,0,5,2,0,2,Gen.G,Attack,0,TALON,6,20,TALON,7,5,2
63,Paper Rex,ZETA DIVISION,Paper Rex,ZETA DIVISION,Split,13,6,7,6,0,1,5,0,1,ZETA DIVISION,Defense,0,Paper Rex,7,19,Paper Rex,7,5,2
63,ZETA DIVISION,Paper Rex,Paper Rex,ZETA DIVISION,Ascent,10,13,6,4,0,8,5,0,2,Paper Rex,Attack,0,Paper Rex,-3,23,ZETA DIVISION,4,8,-4
64,Rex Regum Qeon,Global Esports,Rex Regum Qeon,Global Esports,Fracture,13,10,7,6,0,6,4,0,1,Global Esports,Attack,0,Rex Regum Qeon,3,23,Rex Regum Qeon,6,6,0
64,Global Esports,Rex Regum Qeon,Rex Regum Qeon,Global Esports,Pearl,11,13,7,4,0,8,5,0,2,Rex Regum Qeon,Attack,0,Rex Regum Qeon,-2,24,Global Esports,4,8,-4
65,Team Secret,T1,Team Secret,T1,Lotus,4,13,2,2,0,3,10,0,1,T1,Defense,0,T1,-9,17,Team Secret,2,10,-8
65,T1,Team Secret,Team Secret,T1,Bind,13,8,7,6,0,3,5,0,2,Team Secret,Defense,0,T1,5,21,T1,7,5,2
66,DetonatioN FocusMe,DRX,DetonatioN FocusMe,DRX,Fracture,8,13,1,7,0,5,8,0,1,DRX,Attack,0,DRX,-5,21,DetonatioN FocusMe,7,5,2
66,DRX,DetonatioN FocusMe,DetonatioN FocusMe,DRX,Ascent,13,4,9,4,0,1,3,0,2,DetonatioN FocusMe,Defense,0,DRX,9,17,DRX,9,3,6
67,Paper Rex,Gen.G,Paper Rex,Gen.G,Split,13,7,9,4,0,4,3,0,1,Gen.G,Defense,0,Paper Rex,6,20,Paper Rex,9,3,6
67,Gen.G,Paper Rex,Paper Rex,Gen.G,Ascent,2,13,0,2,0,10,3,0,2,Paper Rex,Attack,0,Paper Rex,-11,15,Gen.G,2,10,-8
68,ZETA DIVISION,T1,ZETA DIVISION,T1,Fracture,11,13,6,5,0,7,6,0,1,T1,Defense,0,T1,-2,24,ZETA DIVISION,6,6,0
68,T1,ZETA DIVISION,ZETA DIVISION,T1,Lotus,10,13,1,9,0,3,10,0,2,ZETA DIVISION,Attack,0,ZETA DIVISION,-3,23,T1,9,3,6
68,T1,ZETA DIVISION,ZETA DIVISION,T1,Bind,13,3,4,9,0,3,0,0,3,ZETA DIVISION,Attack,0,T1,10,16,,9,3,6
69,Team Secret,DRX,Team Secret,DRX,Haven,13,8,5,8,0,4,4,0,1,DRX,Attack,0,Team Secret,5,21,Team Secret,8,4,4
69,DRX,Team Secret,Team Secret,DRX,Ascent,11,13,9,2,0,10,3,0,2,Team Secret,Defense,0,Team Secret,-2,24,DRX,9,3,6
70,DetonatioN FocusMe,Global Esports,DetonatioN FocusMe,Global Esports,Lotus,7,13,3,4,0,8,5,0,1,Global Esports,Attack,0,Global Esports,-6,20,DetonatioN FocusMe,4,8,-4
70,Global Esports,DetonatioN FocusMe,DetonatioN FocusMe,Global Esports,Pearl,13,6,11,2,0,5,1,0,2,DetonatioN FocusMe,Defense,0,Global Esports,7,19,Global Esports,11,1,10
71,Rex Regum Qeon,TALON,Rex Regum Qeon,TALON,Split,3,13,0,3,0,9,4,0,1,TALON,Attack,0,TALON,-10,16,Rex Regum Qeon,3,9,-6
71,TALON,Rex Regum Qeon,Rex Regum Qeon,TALON,Ascent,4,13,1,3,0,9,4,0,2,Rex Regum Qeon,Attack,0,Rex Regum Qeon,-9,17,TALON,3,9,-6
71,TALON,Rex Regum Qeon,Rex Regum Qeon,TALON,Haven,7,13,4,3,0,5,8,0,3,Rex Regum Qeon,Defense,0,Rex Regum Qeon,-6,20,,4,8,-4
72,Gen.G,ZETA DIVISION,Gen.G,ZETA DIVISION,Haven,8,13,4,4,0,8,5,0,1,ZETA DIVISION,Attack,0,ZETA DIVISION,-5,21,Gen.G,4,8,-4
72,ZETA DIVISION,Gen.G,Gen.G,ZETA DIVISION,Ascent,4,13,1,3,0,9,4,0,2,Gen.G,Attack,0,Gen.G,-9,17,ZETA DIVISION,3,9,-6
72,ZETA DIVISION,Gen.G,Gen.G,ZETA DIVISION,Fracture,13,4,5,8,0,4,0,0,3,Gen.G,Attack,0,ZETA DIVISION,9,17,,8,4,4
73,T1,DRX,T1,DRX,Bind,10,13,7,3,0,9,4,0,1,DRX,Attack,0,DRX,-3,23,T1,3,9,-6
73,DRX,T1,T1,DRX,Pearl,13,9,4,9,0,3,6,0,2,T1,Attack,0,DRX,4,22,DRX,9,3,6
74,Team Secret,Global Esports,Team Secret,Global Esports,Haven,13,9,7,6,0,6,3,0,1,Global Esports,Attack,0,Team Secret,4,22,Team Secret,6,6,0
74,Global Esports,Team Secret,Team Secret,Global Esports,Lotus,10,13,5,5,0,7,6,0,2,Team Secret,Attack,0,Team Secret,-3,23,Global Esports,5,7,-2
75,TALON,DetonatioN FocusMe,TALON,DetonatioN FocusMe,Lotus,13,11,7,6,0,6,5,0,1,DetonatioN FocusMe,Attack,0,TALON,2,24,TALON,6,6,0
75,DetonatioN FocusMe,TALON,TALON,DetonatioN FocusMe,Bind,4,13,2,2,0,10,3,0,2,TALON,Attack,0,TALON,-9,17,DetonatioN FocusMe,2,10,-8
76,Rex Regum Qeon,Paper Rex,Rex Regum Qeon,Paper Rex,Bind,9,13,4,5,0,7,6,0,1,Paper Rex,Attack,0,Paper Rex,-4,22,Rex Regum Qeon,5,7,-2
76,Paper Rex,Rex Regum Qeon,Rex Regum Qeon,Paper Rex,Pearl,13,11,5,8,0,4,7,0,2,Rex Regum Qeon,Attack,0,Paper Rex,2,24,Paper Rex,8,4,4
77,Team Secret,ZETA DIVISION,Team Secret,ZETA DIVISION,Haven,15,13,3,9,3,3,9,1,1,ZETA DIVISION,Attack,1,Team Secret,2,28,Team Secret,9,3,6
77,ZETA DIVISION,Team Secret,Team Secret,ZETA DIVISION,Ascent,12,14,5,7,0,5,7,2,2,Team Secret,Defense,1,Team Secret,-2,26,ZETA DIVISION,5,7,-2
78,T1,Gen.G,T1,Gen.G,Fracture,13,8,6,7,0,5,3,0,1,Gen.G,Attack,0,T1,5,21,T1,7,5,2
78,Gen.G,T1,T1,Gen.G,Ascent,13,11,4,9,0,3,8,0,2,T1,Defense,0,Gen.G,2,24,Gen.G,4,8,-4
78,Gen.G,T1,T1,Gen.G,Lotus,7,13,6,1,0,7,6,0,3,T1,Defense,0,T1,-6,20,,6,6,0
79,Team Secret,DRX,Team Secret,DRX,Haven,13,9,8,5,0,5,4,0,1,DRX,Defense,0,Team Secret,4,22,Team Secret,8,4,4
79,DRX,Team Secret,Team Secret,DRX,Split,13,5,10,3,0,3,2,0,2,Team Secret,Defense,0,DRX,8,18,DRX,10,2,8
79,DRX,Team Secret,Team Secret,DRX,Bind,13,4,3,10,0,2,2,0,3,Team Secret,Attack,0,DRX,9,17,,10,2,8
80,T1,Paper Rex,T1,Paper Rex,Lotus,10,13,4,6,0,6,7,0,1,Paper Rex,Attack,0,Paper Rex,-3,23,T1,6,6,0
80,Paper Rex,T1,T1,Paper Rex,Fracture,13,10,5,8,0,4,6,0,2,T1,Attack,0,Paper Rex,3,23,Paper Rex,8,4,4
81,Gen.G,Team Secret,Gen.G,Team Secret,Ascent,8,13,6,2,0,7,6,0,1,Team Secret,Defense,0,Team Secret,-5,21,Gen.G,6,6,0
81,Team Secret,Gen.G,Gen.G,Team Secret,Haven,8,13,6,2,0,10,3,0,2,Gen.G,Attack,0,Gen.G,-5,21,Team Secret,2,10,-8
81,Team Secret,Gen.G,Gen.G,Team Secret,Split,12,14,5,7,0,5,7,2,3,Gen.G,Attack,1,Gen.G,-2,26,,7,5,2
82,ZETA DIVISION,T1,ZETA DIVISION,T1,Haven,10,13,4,6,0,5,8,0,1,T1,Defense,0,T1,-3,23,ZETA DIVISION,4,8,-4
82,T1,ZETA DIVISION,ZETA DIVISION,T1,Bind,12,14,7,5,0,7,5,2,2,ZETA DIVISION,Attack,1,ZETA DIVISION,-2,26,T1,5,7,-2
82,T1,ZETA DIVISION,ZETA DIVISION,T1,Fracture,13,10,8,5,0,7,3,0,3,ZETA DIVISION,Attack,0,T1,3,23,,5,7,-2
83,Paper Rex,DRX,Paper Rex,DRX,Fracture,13,5,6,7,0,5,0,0,1,DRX,Attack,0,Paper Rex,8,18,Paper Rex,7,5,2
83,DRX,Paper Rex,Paper Rex,DRX,Bind,6,13,2,4,0,8,5,0,2,Paper Rex,Attack,0,Paper Rex,-7,19,DRX,4,8,-4
84,T1,Gen.G,T1,Gen.G,Fracture,13,10,8,5,0,7,3,0,1,Gen.G,Attack,0,T1,3,23,T1,5,7,-2
84,Gen.G,T1,T1,Gen.G,Ascent,10,13,5,5,0,6,7,0,2,T1,Defense,0,T1,-3,23,Gen.G,5,7,-2
85,DRX,T1,DRX,T1,Ascent,11,13,9,2,0,10,3,0,1,T1,Defense,0,T1,-2,24,DRX,9,3,6
85,T1,DRX,DRX,T1,Fracture,11,13,3,8,0,4,9,0,2,DRX,Attack,0,DRX,-2,24,T1,8,4,4
85,DRX,T1,DRX,T1,Haven,13,11,9,4,0,8,3,0,3,T1,Defense,0,DRX,2,24,DRX,9,3,6
85,T1,DRX,DRX,T1,Bind,13,6,5,8,0,4,2,0,4,DRX,Attack,0,T1,7,19,T1,8,4,4
85,DRX,T1,DRX,T1,Pearl,13,9,8,5,0,5,4,0,5,T1,Defense,0,DRX,4,22,,8,4,4
86,Paper Rex,DRX,Paper Rex,DRX,Fracture,6,13,3,3,0,9,4,0,1,DRX,Attack,0,DRX,-7,19,Paper Rex,3,9,-6
86,DRX,Paper Rex,Paper Rex,DRX,Ascent,16,14,6,6,4,6,6,2,2,Paper Rex,Attack,1,DRX,2,30,DRX,6,6,0
86,Paper Rex,DRX,Paper Rex,DRX,Lotus,13,3,4,9,0,3,0,0,3,DRX,Attack,0,Paper Rex,10,16,Paper Rex,9,3,6
86,DRX,Paper Rex,Paper Rex,DRX,Pearl,8,13,4,4,0,8,5,0,4,Paper Rex,Attack,0,Paper Rex,-5,21,DRX,4,8,-4
86,Paper Rex,DRX,Paper Rex,DRX,Bind,13,6,4,9,0,3,3,0,5,DRX,Attack,0,Paper Rex,7,19,,9,3,6
87,Natus Vincere,KOI,Natus Vincere,KOI,Ascent,7,13,4,3,0,5,8,0,1,KOI,Defense,0,KOI,-6,20,Natus Vincere,4,8,-4
87,KOI,Natus Vincere,Natus Vincere,KOI,Lotus,20,18,3,9,8,3,9,6,2,Natus Vincere,Defense,1,KOI,2,38,KOI,3,9,-6
88,FNATIC,GIANTX,FNATIC,GIANTX,Icebox,13,3,3,10,0,2,1,0,1,GIANTX,Attack,0,FNATIC,10,16,FNATIC,10,2,8
88,GIANTX,FNATIC,FNATIC,GIANTX,Split,11,13,6,5,0,7,6,0,2,FNATIC,Defense,0,FNATIC,-2,24,GIANTX,6,6,0
89,Team Heretics,FUT Esports,Team Heretics,FUT Esports,Pearl,4,13,2,2,0,3,10,0,1,FUT Esports,Defense,0,FUT Esports,-9,17,Team Heretics,2,10,-8
89,FUT Esports,Team Heretics,Team Heretics,FUT Esports,Lotus,13,9,9,4,0,8,1,0,2,Team Heretics,Attack,0,FUT Esports,4,22,FUT Esports,4,8,-4
90,Team Vitality,Team Liquid,Team Vitality,Team Liquid,Haven,13,6,9,4,0,3,3,0,1,Team Liquid,Defense,0,Team Vitality,7,19,Team Vitality,9,3,6
90,Team Liquid,Team Vitality,Team Vitality,Team Liquid,Fracture,13,2,3,10,0,2,0,0,2,Team Vitality,Attack,0,Team Liquid,11,15,Team Liquid,10,2,8
90,Team Liquid,Team Vitality,Team Vitality,Team Liquid,Lotus,10,13,3,7,0,5,8,0,3,Team Vitality,Attack,0,Team Vitality,-3,23,,7,5,2
91,Natus Vincere,GIANTX,Natus Vincere,GIANTX,Icebox,15,17,6,6,3,6,6,5,1,GIANTX,Defense,1,GIANTX,-2,32,Natus Vincere,6,6,0
91,GIANTX,Natus Vincere,Natus Vincere,GIANTX,Split,13,15,5,7,1,5,7,3,2,Natus Vincere,Defense,1,Natus Vincere,-2,28,GIANTX,5,7,-2
91,GIANTX,Natus Vincere,Natus Vincere,GIANTX,Pearl,7,13,5,2,0,6,7,0,3,Natus Vincere,Defense,0,Natus Vincere,-6,20,,5,7,-2
92,BBL Esports,Karmine Corp,BBL Esports,Karmine Corp,Icebox,17,19,6,6,5,6,6,7,1,Karmine Corp,Defense,1,Karmine Corp,-2,36,BBL Esports,6,6,0
92,Karmine Corp,BBL Esports,BBL Esports,Karmine Corp,Split,13,11,9,4,0,8,3,0,2,BBL Esports,Defense,0,Karmine Corp,2,24,Karmine Corp,9,3,6
93,FUT Esports,Team Liquid,FUT Esports,Team Liquid,Lotus,13,10,7,6,0,5,5,0,1,Team Liquid,Defense,0,FUT Esports,3,23,FUT Esports,7,5,2
93,Team Liquid,FUT Esports,FUT Esports,Team Liquid,Split,13,6,7,6,0,1,5,0,2,FUT Esports,Defense,0,Team Liquid,7,19,Team Liquid,7,5,2
93,Team Liquid,FUT Esports,FUT Esports,Team Liquid,Ascent,13,6,6,7,0,0,6,0,3,FUT Esports,Defense,0,Team Liquid,7,19,,6,6,0
94,Team Vitality,KOI,Team Vitality,KOI,Split,13,9,8,5,0,7,2,0,1,KOI,Attack,0,Team Vitality,4,22,Team Vitality,5,7,-2
94,KOI,Team Vitality,Team Vitality,KOI,Fracture,13,15,4,8,1,4,8,3,2,Team Vitality,Defense,1,Team Vitality,-2,28,KOI,4,8,-4
95,BBL Esports,FNATIC,BBL Esports,FNATIC,Ascent,13,6,9,4,0,3,3,0,1,FNATIC,Defense,0,BBL Esports,7,19,BBL Esports,9,3,6
95,FNATIC,BBL Esports,BBL Esports,FNATIC,Haven,13,9,5,8,0,4,5,0,2,BBL Esports,Attack,0,FNATIC,4,22,FNATIC,8,4,4
95,FNATIC,BBL Esports,BBL Esports,FNATIC,Split,13,11,6,7,0,5,6,0,3,BBL Esports,Defense,0,FNATIC,2,24,,6,6,0
96,Team Heretics,Karmine Corp,Team Heretics,Karmine Corp,Icebox,13,5,9,4,0,2,3,0,1,Karmine Corp,Defense,0,Team Heretics,8,18,Team Heretics,9,3,6
96,Karmine Corp,Team Heretics,Team Heretics,Karmine Corp,Split,2,13,2,0,0,3,10,0,2,Team Heretics,Defense,0,Team Heretics,-11,15,Karmine Corp,2,10,-8
97,FUT Esports,Team Vitality,FUT Esports,Team Vitality,Lotus,13,4,9,4,0,1,3,0,1,Team Vitality,Defense,0,FUT Esports,9,17,FUT Esports,9,3,6
97,Team Vitality,FUT Esports,FUT Esports,Team Vitality,Haven,10,13,5,5,0,6,7,0,2,FUT Esports,Defense,0,FUT Esports,-3,23,Team Vitality,5,7,-2
98,BBL Esports,Natus Vincere,BBL Esports,Natus Vincere,Ascent,10,13,6,4,0,7,6,0,1,Natus Vincere,Defense,0,Natus Vincere,-3,23,BBL Esports,6,6,0
98,Natus Vincere,BBL Esports,BBL Esports,Natus Vincere,Fracture,13,8,6,7,0,2,6,0,2,BBL Esports,Defense,0,Natus Vincere,5,21,Natus Vincere,6,6,0
99,FNATIC,Team Heretics,FNATIC,Team Heretics,Icebox,13,3,4,9,0,3,0,0,1,Team Heretics,Attack,0,FNATIC,10,16,FNATIC,9,3,6
99,Team Heretics,FNATIC,FNATIC,Team Heretics,Ascent,6,13,1,5,0,7,6,0,2,FNATIC,Attack,0,FNATIC,-7,19,Team Heretics,5,7,-2
100,Team Liquid,Karmine Corp,Team Liquid,Karmine Corp,Ascent,13,5,8,5,0,1,4,0,1,Karmine Corp,Defense,0,Team Liquid,8,18,Team Liquid,8,4,4
100,Karmine Corp,Team Liquid,Team Liquid,Karmine Corp,Split,2,13,0,2,0,1,12,0,2,Team Liquid,Defense,0,Team Liquid,-11,15,Karmine Corp,0,12,-12
101,GIANTX,KOI,GIANTX,KOI,Lotus,13,1,2,11,0,1,0,0,1,KOI,Attack,0,GIANTX,12,14,GIANTX,11,1,10
101,KOI,GIANTX,GIANTX,KOI,Ascent,11,13,4,7,0,5,8,0,2,GIANTX,Defense,0,GIANTX,-2,24,KOI,4,8,-4
102,Natus Vincere,Team Heretics,Natus Vincere,Team Heretics,Pearl,13,3,9,4,0,0,3,0,1,Team Heretics,Defense,0,Natus Vincere,10,16,Natus Vincere,9,3,6
102,Team Heretics,Natus Vincere,Natus Vincere,Team Heretics,Lotus,13,9,10,3,0,7,2,0,2,Natus Vincere,Defense,0,Team Heretics,4,22,Team Heretics,10,2,8
102,Team Heretics,Natus Vincere,Natus Vincere,Team Heretics,Ascent,2,13,1,1,0,2,11,0,3,Natus Vincere,Defense,0,Natus Vincere,-11,15,,1,11,-10
103,FUT Esports,KOI,FUT Esports,KOI,Icebox,13,6,6,7,0,5,1,0,2,KOI,Attack,0,FUT Esports,7,19,FUT Esports,7,5,2
103,KOI,FUT Esports,FUT Esports,KOI,Ascent,9,13,6,3,0,7,6,0,1,FUT Esports,Defense,0,FUT Esports,-4,22,KOI,6,6,0
104,Team Liquid,FNATIC,Team Liquid,FNATIC,Lotus,6,13,5,1,0,11,2,0,1,FNATIC,Attack,0,FNATIC,-7,19,Team Liquid,1,11,-10
104,FNATIC,Team Liquid,Team Liquid,FNATIC,Haven,13,6,6,7,0,0,6,0,2,Team Liquid,Defense,0,FNATIC,7,19,FNATIC,6,6,0
105,BBL Esports,GIANTX,BBL Esports,GIANTX,Icebox,10,13,5,5,0,6,7,0,1,GIANTX,Defense,0,GIANTX,-3,23,BBL Esports,5,7,-2
105,GIANTX,BBL Esports,BBL Esports,GIANTX,Split,13,3,9,4,0,0,3,0,2,BBL Esports,Defense,0,GIANTX,10,16,GIANTX,9,3,6
106,Karmine Corp,Team Vitality,Karmine Corp,Team Vitality,Ascent,2,13,2,0,0,3,10,0,1,Team Vitality,Defense,0,Team Vitality,-11,15,Karmine Corp,2,10,-8
106,Team Vitality,Karmine Corp,Karmine Corp,Team Vitality,Split,13,6,11,2,0,5,1,0,2,Karmine Corp,Defense,0,Team Vitality,7,19,Team Vitality,11,1,10
107,Team Liquid,Team Heretics,Team Liquid,Team Heretics,Split,13,8,10,3,0,6,2,0,1,Team Heretics,Defense,0,Team Liquid,5,21,Team Liquid,10,2,8
107,Team Heretics,Team Liquid,Team Liquid,Team Heretics,Fracture,15,17,5,7,3,5,7,5,2,Team Liquid,Defense,1,Team Liquid,-2,32,Team Heretics,5,7,-2
108,FUT Esports,GIANTX,FUT Esports,GIANTX,Icebox,5,13,2,3,0,3,10,0,1,GIANTX,Defense,0,GIANTX,-8,18,FUT Esports,2,10,-8
108,GIANTX,FUT Esports,FUT Esports,GIANTX,Split,13,11,8,5,0,7,4,0,2,FUT Esports,Defense,0,GIANTX,2,24,GIANTX,8,4,4
109,Natus Vincere,Karmine Corp,Natus Vincere,Karmine Corp,Ascent,13,11,6,7,0,5,6,0,1,Karmine Corp,Defense,0,Natus Vincere,2,24,Natus Vincere,6,6,0
109,Karmine Corp,Natus Vincere,Natus Vincere,Karmine Corp,Lotus,7,13,7,0,0,8,5,0,2,Natus Vincere,Defense,0,Natus Vincere,-6,20,Karmine Corp,7,5,2
110,BBL Esports,Team Vitality,BBL Esports,Team Vitality,Ascent,13,8,5,8,0,1,7,0,1,Team Vitality,Defense,0,BBL Esports,5,21,BBL Esports,5,7,-2
110,Team Vitality,BBL Esports,BBL Esports,Team Vitality,Haven,9,13,3,6,0,4,9,0,2,BBL Esports,Defense,0,BBL Esports,-4,22,Team Vitality,3,9,-6
111,Team Liquid,GIANTX,Team Liquid,GIANTX,Ascent,11,13,5,6,0,6,7,0,1,GIANTX,Defense,0,GIANTX,-2,24,Team Liquid,5,7,-2
111,GIANTX,Team Liquid,Team Liquid,GIANTX,Icebox,11,13,6,5,0,7,6,0,2,Team Liquid,Attack,0,Team Liquid,-2,24,GIANTX,5,7,-2
111,GIANTX,Team Liquid,Team Liquid,GIANTX,Lotus,10,13,5,5,0,7,6,0,3,Team Liquid,Attack,0,Team Liquid,-3,23,,5,7,-2
112,BBL Esports,Team Heretics,BBL Esports,Team Heretics,Haven,14,12,7,5,2,7,5,0,1,Team Heretics,Defense,1,BBL Esports,2,26,BBL Esports,7,5,2
112,Team Heretics,BBL Esports,BBL Esports,Team Heretics,Lotus,13,10,7,6,0,6,4,0,2,BBL Esports,Attack,0,Team Heretics,3,23,Team Heretics,6,6,0
112,Team Heretics,BBL Esports,BBL Esports,Team Heretics,Icebox,2,13,1,1,0,2,11,0,3,BBL Esports,Defense,0,BBL Esports,-11,15,,1,11,-10
113,Karmine Corp,KOI,Karmine Corp,KOI,Lotus,13,6,2,11,0,1,5,0,1,KOI,Attack,0,Karmine Corp,7,19,Karmine Corp,11,1,10
113,KOI,Karmine Corp,Karmine Corp,KOI,Ascent,13,8,6,7,0,2,6,0,2,Karmine Corp,Defense,0,KOI,5,21,KOI,6,6,0
113,KOI,Karmine Corp,Karmine Corp,KOI,Haven,11,13,4,7,0,5,8,0,3,Karmine Corp,Attack,0,Karmine Corp,-2,24,,7,5,2
114,FNATIC,FUT Esports,FNATIC,FUT Esports,Icebox,13,5,6,7,0,5,0,0,1,FUT Esports,Attack,0,FNATIC,8,18,FNATIC,7,5,2
114,FUT Esports,FNATIC,FNATIC,FUT Esports,Lotus,5,13,1,4,0,8,5,0,2,FNATIC,Attack,0,FNATIC,-8,18,FUT Esports,4,8,-4
115,Team Vitality,Natus Vincere,Team Vitality,Natus Vincere,Split,10,13,3,7,0,4,9,0,1,Natus Vincere,Defense,0,Natus Vincere,-3,23,Team Vitality,3,9,-6
115,Natus Vincere,Team Vitality,Team Vitality,Natus Vincere,Fracture,13,10,7,6,0,5,5,0,2,Team Vitality,Defense,0,Natus Vincere,3,23,Natus Vincere,7,5,2
116,FNATIC,Team Vitality,FNATIC,Team Vitality,Haven,14,12,5,7,2,5,7,0,1,Team Vitality,Defense,1,FNATIC,2,26,FNATIC,5,7,-2
116,Team Vitality,FNATIC,FNATIC,Team Vitality,Bind,8,13,2,6,0,6,7,0,2,FNATIC,Attack,0,FNATIC,-5,21,Team Vitality,6,6,0
117,FUT Esports,Karmine Corp,FUT Esports,Karmine Corp,Haven,13,8,6,7,0,5,3,0,1,Karmine Corp,Attack,0,FUT Esports,5,21,FUT Esports,7,5,2
117,Karmine Corp,FUT Esports,FUT Esports,Karmine Corp,Ascent,5,13,4,1,0,5,8,0,2,FUT Esports,Defense,0,FUT Esports,-8,18,Karmine Corp,4,8,-4
118,KOI,BBL Esports,KOI,BBL Esports,Pearl,13,3,4,9,0,3,0,0,1,BBL Esports,Attack,0,KOI,10,16,KOI,9,3,6
118,BBL Esports,KOI,KOI,BBL Esports,Ascent,13,4,9,4,0,1,3,0,2,KOI,Defense,0,BBL Esports,9,17,BBL Esports,9,3,6
118,BBL Esports,KOI,KOI,BBL Esports,Bind,13,5,7,6,0,0,5,0,3,KOI,Defense,0,BBL Esports,8,18,,7,5,2
119,Natus Vincere,Team Liquid,Natus Vincere,Team Liquid,Fracture,13,11,7,6,0,6,5,0,1,Team Liquid,Attack,0,Natus Vincere,2,24,Natus Vincere,6,6,0
119,Team Liquid,Natus Vincere,Natus Vincere,Team Liquid,Bind,11,13,4,7,0,5,8,0,2,Natus Vincere,Attack,0,Natus Vincere,-2,24,Team Liquid,7,5,2
120,GIANTX,Team Heretics,GIANTX,Team Heretics,Pearl,9,13,6,3,0,9,4,0,1,Team Heretics,Attack,0,Team Heretics,-4,22,GIANTX,3,9,-6
120,Team Heretics,GIANTX,GIANTX,Team Heretics,Lotus,16,14,5,7,4,5,7,2,2,GIANTX,Defense,1,Team Heretics,2,30,Team Heretics,5,7,-2
121,FNATIC,KOI,FNATIC,KOI,Lotus,13,4,10,3,0,2,2,0,1,KOI,Defense,0,FNATIC,9,17,FNATIC,10,2,8
121,KOI,FNATIC,FNATIC,KOI,Ascent,9,13,1,8,0,4,9,0,2,FNATIC,Attack,0,FNATIC,-4,22,KOI,8,4,4
122,GIANTX,Team Vitality,GIANTX,Team Vitality,Lotus,13,6,5,8,0,4,2,0,1,Team Vitality,Attack,0,GIANTX,7,19,GIANTX,8,4,4
122,Team Vitality,GIANTX,GIANTX,Team Vitality,Split,13,10,7,6,0,5,5,0,2,GIANTX,Defense,0,Team Vitality,3,23,Team Vitality,7,5,2
122,Team Vitality,GIANTX,GIANTX,Team Vitality,Ascent,10,13,5,5,0,6,7,0,3,GIANTX,Defense,0,GIANTX,-3,23,,5,7,-2
123,FUT Esports,Natus Vincere,FUT Esports,Natus Vincere,Lotus,9,13,3,6,0,4,9,0,1,Natus Vincere,Defense,0,Natus Vincere,-4,22,FUT Esports,3,9,-6
123,Natus Vincere,FUT Esports,FUT Esports,Natus Vincere,Pearl,13,11,4,9,0,3,8,0,2,FUT Esports,Attack,0,Natus Vincere,2,24,Natus Vincere,9,3,6
124,FNATIC,Karmine Corp,FNATIC,Karmine Corp,Haven,13,2,3,10,0,2,0,0,1,Karmine Corp,Attack,0,FNATIC,11,15,FNATIC,10,2,8
124,Karmine Corp,FNATIC,FNATIC,Karmine Corp,Lotus,10,13,4,6,0,6,7,0,2,FNATIC,Attack,0,FNATIC,-3,23,Karmine Corp,6,6,0
125,Team Liquid,BBL Esports,Team Liquid,BBL Esports,Split,13,11,9,4,0,8,3,0,1,BBL Esports,Defense,0,Team Liquid,2,24,Team Liquid,9,3,6
125,BBL Esports,Team Liquid,Team Liquid,BBL Esports,Ascent,13,7,8,5,0,3,4,0,2,Team Liquid,Defense,0,BBL Esports,6,20,BBL Esports,8,4,4
125,BBL Esports,Team Liquid,Team Liquid,BBL Esports,Bind,7,13,2,5,0,7,6,0,3,Team Liquid,Attack,0,Team Liquid,-6,20,,5,7,-2
126,KOI,Team Heretics,KOI,Team Heretics,Fracture,13,7,9,4,0,4,3,0,1,Team Heretics,Defense,0,KOI,6,20,KOI,9,3,6
126,Team Heretics,KOI,KOI,Team Heretics,Lotus,13,9,8,5,0,7,2,0,2,KOI,Attack,0,Team Heretics,4,22,Team Heretics,5,7,-2
126,Team Heretics,KOI,KOI,Team Heretics,Ascent,11,13,7,4,0,8,5,0,3,KOI,Defense,0,KOI,-2,24,,7,5,2
127,FNATIC,Natus Vincere,FNATIC,Natus Vincere,Lotus,13,9,7,6,0,6,3,0,1,Natus Vincere,Attack,0,FNATIC,4,22,FNATIC,6,6,0
127,Natus Vincere,FNATIC,FNATIC,Natus Vincere,Split,8,13,4,4,0,5,8,0,2,FNATIC,Defense,0,FNATIC,-5,21,Natus Vincere,4,8,-4
128,Team Vitality,Team Heretics,Team Vitality,Team Heretics,Haven,13,10,4,9,0,2,8,0,1,Team Heretics,Defense,0,Team Vitality,3,23,Team Vitality,4,8,-4
128,Team Heretics,Team Vitality,Team Vitality,Team Heretics,Lotus,13,15,8,4,1,8,4,3,2,Team Vitality,Attack,1,Team Vitality,-2,28,Team Heretics,4,8,-4
129,Karmine Corp,GIANTX,Karmine Corp,GIANTX,Lotus,14,16,9,3,2,9,3,4,1,GIANTX,Defense,1,GIANTX,-2,30,Karmine Corp,9,3,6
129,GIANTX,Karmine Corp,Karmine Corp,GIANTX,Ascent,13,5,8,5,0,1,4,0,2,Karmine Corp,Defense,0,GIANTX,8,18,GIANTX,8,4,4
130,Team Liquid,KOI,Team Liquid,KOI,Fracture,13,7,6,7,0,5,2,0,1,KOI,Attack,0,Team Liquid,6,20,Team Liquid,7,5,2
130,KOI,Team Liquid,Team Liquid,KOI,Split,13,11,8,5,0,7,4,0,2,Team Liquid,Attack,0,KOI,2,24,KOI,5,7,-2
130,KOI,Team Liquid,Team Liquid,KOI,Lotus,8,13,5,3,0,6,7,0,3,Team Liquid,Defense,0,Team Liquid,-5,21,,5,7,-2
131,FUT Esports,BBL Esports,FUT Esports,BBL Esports,Pearl,13,5,7,6,0,0,5,0,1,BBL Esports,Defense,0,FUT Esports,8,18,FUT Esports,7,5,2
131,BBL Esports,FUT Esports,FUT Esports,BBL Esports,Haven,7,13,5,2,0,10,3,0,2,FUT Esports,Attack,0,FUT Esports,-6,20,BBL Esports,2,10,-8
132,FUT Esports,GIANTX,FUT Esports,GIANTX,Haven,13,5,4,9,0,3,2,0,1,GIANTX,Attack,0,FUT Esports,8,18,FUT Esports,9,3,6
132,GIANTX,FUT Esports,FUT Esports,GIANTX,Ascent,12,14,3,9,0,3,9,2,2,FUT Esports,Defense,1,FUT Esports,-2,26,GIANTX,3,9,-6
133,Team Vitality,Team Liquid,Team Vitality,Team Liquid,Lotus,13,6,4,9,0,3,3,0,1,Team Liquid,Attack,0,Team Vitality,7,19,Team Vitality,9,3,6
133,Team Liquid,Team Vitality,Team Vitality,Team Liquid,Bind,13,11,5,8,0,4,7,0,2,Team Vitality,Attack,0,Team Liquid,2,24,Team Liquid,8,4,4
133,Team Liquid,Team Vitality,Team Vitality,Team Liquid,Ascent,13,11,6,7,0,5,6,0,3,Team Vitality,Defense,0,Team Liquid,2,24,,6,6,0
134,FNATIC,FUT Esports,FNATIC,FUT Esports,Bind,9,13,8,1,0,9,4,0,1,FUT Esports,Defense,0,FUT Esports,-4,22,FNATIC,8,4,4
134,FUT Esports,FNATIC,FNATIC,FUT Esports,Split,2,13,2,0,0,3,10,0,2,FNATIC,Defense,0,FNATIC,-11,15,FUT Esports,2,10,-8
134,FUT Esports,FNATIC,FNATIC,FUT Esports,Lotus,1,13,0,1,0,11,2,0,3,FNATIC,Attack,0,FNATIC,-12,14,,1,11,-10
135,Team Liquid,Natus Vincere,Team Liquid,Natus Vincere,Bind,13,11,4,9,0,3,8,0,1,Natus Vincere,Defense,0,Team Liquid,2,24,Team Liquid,4,8,-4
135,Natus Vincere,Team Liquid,Team Liquid,Natus Vincere,Split,10,13,8,2,0,9,4,0,2,Team Liquid,Defense,0,Team Liquid,-3,23,Natus Vincere,8,4,4
136,Team Vitality,FUT Esports,Team Vitality,FUT Esports,Split,9,13,8,1,0,9,4,0,1,FUT Esports,Defense,0,FUT Esports,-4,22,Team Vitality,8,4,4
136,FUT Esports,Team Vitality,Team Vitality,FUT Esports,Haven,9,13,5,4,0,8,5,0,2,Team Vitality,Attack,0,Team Vitality,-4,22,FUT Esports,4,8,-4
136,FUT Esports,Team Vitality,Team Vitality,FUT Esports,Lotus,13,6,4,9,0,3,3,0,3,Team Vitality,Attack,0,FUT Esports,7,19,,9,3,6
137,Natus Vincere,GIANTX,Natus Vincere,GIANTX,Pearl,13,9,6,7,0,3,6,0,1,GIANTX,Defense,0,Natus Vincere,4,22,Natus Vincere,6,6,0
137,GIANTX,Natus Vincere,Natus Vincere,GIANTX,Ascent,9,13,4,5,0,5,8,0,2,Natus Vincere,Defense,0,Natus Vincere,-4,22,GIANTX,4,8,-4
138,FNATIC,Team Liquid,FNATIC,Team Liquid,Lotus,14,12,7,5,2,7,5,0,1,Team Liquid,Defense,1,FNATIC,2,26,FNATIC,7,5,2
138,Team Liquid,FNATIC,FNATIC,Team Liquid,Bind,6,13,6,0,0,7,6,0,2,FNATIC,Defense,0,FNATIC,-7,19,Team Liquid,6,6,0
139,FUT Esports,Natus Vincere,FUT Esports,Natus Vincere,Lotus,13,8,10,3,0,6,2,0,1,Natus Vincere,Defense,0,FUT Esports,5,21,FUT Esports,10,2,8
139,Natus Vincere,FUT Esports,FUT Esports,Natus Vincere,Fracture,7,13,3,4,0,8,5,0,2,FUT Esports,Attack,0,FUT Esports,-6,20,Natus Vincere,4,8,-4
140,Team Liquid,FUT Esports,Team Liquid,FUT Esports,Ascent,13,5,9,4,0,2,3,0,1,FUT Esports,Defense,0,Team Liquid,8,18,Team Liquid,9,3,6
140,FUT Esports,Team Liquid,Team Liquid,FUT Esports,Lotus,15,17,10,2,3,10,2,5,2,Team Liquid,Defense,1,Team Liquid,-2,32,FUT Esports,10,2,8
140,Team Liquid,FUT Esports,Team Liquid,FUT Esports,Split,13,5,7,6,0,0,5,0,3,FUT Esports,Defense,0,Team Liquid,8,18,Team Liquid,7,5,2
141,FNATIC,Team Liquid,FNATIC,Team Liquid,Lotus,13,11,8,5,0,7,4,0,1,Team Liquid,Defense,0,FNATIC,2,24,FNATIC,8,4,4
141,Team Liquid,FNATIC,FNATIC,Team Liquid,Ascent,14,12,4,8,2,4,8,0,2,FNATIC,Attack,1,Team Liquid,2,26,Team Liquid,8,4,4
141,FNATIC,Team Liquid,FNATIC,Team Liquid,Haven,6,13,4,2,0,5,8,0,3,Team Liquid,Defense,0,Team Liquid,-7,19,FNATIC,4,8,-4
141,Team Liquid,FNATIC,FNATIC,Team Liquid,Fracture,13,11,5,8,0,4,7,0,4,FNATIC,Attack,0,Team Liquid,2,24,Team Liquid,8,4,4
142,Sentinels,100 Thieves,Sentinels,100 Thieves,Fracture,13,11,6,7,0,5,6,0,1,100 Thieves,Attack,0,Sentinels,2,24,Sentinels,7,5,2
142,100 Thieves,Sentinels,Sentinels,100 Thieves,Split,14,12,5,7,2,5,7,0,2,Sentinels,Defense,1,100 Thieves,2,26,100 Thieves,5,7,-2
142,100 Thieves,Sentinels,Sentinels,100 Thieves,Ascent,12,14,8,4,0,8,4,2,3,Sentinels,Defense,1,Sentinels,-2,26,,8,4,4
143,KRÜ Esports,FURIA,KRÜ Esports,FURIA,Split,11,13,6,5,0,7,6,0,1,FURIA,Defense,0,FURIA,-2,24,KRÜ Esports,6,6,0
143,FURIA,KRÜ Esports,KRÜ Esports,FURIA,Ascent,13,5,7,6,0,0,5,0,2,KRÜ Esports,Defense,0,FURIA,8,18,FURIA,7,5,2
144,LOUD,MIBR,LOUD,MIBR,Split,13,5,5,8,0,4,1,0,1,MIBR,Attack,0,LOUD,8,18,LOUD,8,4,4
144,MIBR,LOUD,LOUD,MIBR,Lotus,13,11,6,7,0,5,6,0,2,LOUD,Attack,0,MIBR,2,24,MIBR,7,5,2
144,MIBR,LOUD,LOUD,MIBR,Haven,11,13,7,4,0,8,5,0,3,LOUD,Attack,0,LOUD,-2,24,,4,8,-4
145,Evil Geniuses,Cloud9,Evil Geniuses,Cloud9,Pearl,11,13,2,9,0,3,10,0,1,Cloud9,Attack,0,Cloud9,-2,24,Evil Geniuses,9,3,6
145,Cloud9,Evil Geniuses,Evil Geniuses,Cloud9,Fracture,13,9,8,5,0,5,4,0,2,Evil Geniuses,Defense,0,Cloud9,4,22,Cloud9,8,4,4
146,LEVIATÁN,NRG Esports,LEVIATÁN,NRG Esports,Pearl,13,11,7,6,0,6,5,0,1,NRG Esports,Attack,0,LEVIATÁN,2,24,LEVIATÁN,6,6,0
146,NRG Esports,LEVIATÁN,LEVIATÁN,NRG Esports,Lotus,4,13,4,0,0,5,8,0,2,LEVIATÁN,Defense,0,LEVIATÁN,-9,17,NRG Esports,4,8,-4
147,Cloud9,LOUD,Cloud9,LOUD,Split,13,7,8,5,0,3,4,0,1,LOUD,Defense,0,Cloud9,6,20,Cloud9,8,4,4
147,LOUD,Cloud9,Cloud9,LOUD,Ascent,13,8,9,4,0,5,3,0,2,Cloud9,Defense,0,LOUD,5,21,LOUD,9,3,6
147,LOUD,Cloud9,Cloud9,LOUD,Pearl,13,7,5,8,0,4,3,0,3,Cloud9,Attack,0,LOUD,6,20,,8,4,4
148,LEVIATÁN,FURIA,LEVIATÁN,FURIA,Pearl,13,11,10,3,0,9,2,0,1,FURIA,Attack,0,LEVIATÁN,2,24,LEVIATÁN,3,9,-6
148,FURIA,LEVIATÁN,LEVIATÁN,FURIA,Icebox,13,5,10,3,0,3,2,0,2,LEVIATÁN,Defense,0,FURIA,8,18,FURIA,10,2,8
148,FURIA,LEVIATÁN,LEVIATÁN,FURIA,Ascent,13,10,3,10,0,1,9,0,3,LEVIATÁN,Defense,0,FURIA,3,23,,3,9,-6
149,Sentinels,NRG Esports,Sentinels,NRG Esports,Lotus,10,13,7,3,0,9,4,0,1,NRG Esports,Attack,0,NRG Esports,-3,23,Sentinels,3,9,-6
149,NRG Esports,Sentinels,Sentinels,NRG Esports,Icebox,13,2,3,10,0,2,0,0,2,Sentinels,Attack,0,NRG Esports,11,15,NRG Esports,10,2,8
150,KRÜ Esports,MIBR,KRÜ Esports,MIBR,Ascent,13,9,5,8,0,2,7,0,1,MIBR,Defense,0,KRÜ Esports,4,22,KRÜ Esports,5,7,-2
150,MIBR,KRÜ Esports,KRÜ Esports,MIBR,Lotus,13,11,9,4,0,8,3,0,2,KRÜ Esports,Attack,0,MIBR,2,24,MIBR,4,8,-4
150,MIBR,KRÜ Esports,KRÜ Esports,MIBR,Pearl,14,12,7,5,2,7,5,0,3,KRÜ Esports,Defense,1,MIBR,2,26,,7,5,2
151,Evil Geniuses,100 Thieves,Evil Geniuses,100 Thieves,Haven,9,13,3,6,0,6,7,0,1,100 Thieves,Attack,0,100 Thieves,-4,22,Evil Geniuses,6,6,0
151,100 Thieves,Evil Geniuses,Evil Geniuses,100 Thieves,Icebox,13,5,9,4,0,2,3,0,2,Evil Geniuses,Defense,0,100 Thieves,8,18,100 Thieves,9,3,6
152,Cloud9,100 Thieves,Cloud9,100 Thieves,Lotus,13,7,5,8,0,4,3,0,1,100 Thieves,Attack,0,Cloud9,6,20,Cloud9,8,4,4
152,100 Thieves,Cloud9,Cloud9,100 Thieves,Ascent,12,14,4,8,0,4,8,2,2,Cloud9,Defense,1,Cloud9,-2,26,100 Thieves,4,8,-4
153,NRG Esports,MIBR,NRG Esports,MIBR,Icebox,10,13,6,4,0,7,6,0,1,MIBR,Defense,0,MIBR,-3,23,NRG Esports,6,6,0
153,MIBR,NRG Esports,NRG Esports,MIBR,Pearl,14,16,8,4,2,8,4,4,2,NRG Esports,Attack,1,NRG Esports,-2,30,MIBR,4,8,-4
153,MIBR,NRG Esports,NRG Esports,MIBR,Split,16,14,4,8,4,4,8,2,3,NRG Esports,Defense,1,MIBR,2,30,,4,8,-4
154,Sentinels,LEVIATÁN,Sentinels,LEVIATÁN,Split,12,14,7,5,0,7,5,2,1,LEVIATÁN,Defense,1,LEVIATÁN,-2,26,Sentinels,7,5,2
154,LEVIATÁN,Sentinels,Sentinels,LEVIATÁN,Ascent,11,13,5,6,0,6,7,0,2,Sentinels,Defense,0,Sentinels,-2,24,LEVIATÁN,5,7,-2
154,LEVIATÁN,Sentinels,Sentinels,LEVIATÁN,Pearl,13,4,3,10,0,2,2,0,3,Sentinels,Attack,0,LEVIATÁN,9,17,,10,2,8
155,Evil Geniuses,KRÜ Esports,Evil Geniuses,KRÜ Esports,Pearl,13,11,10,3,0,9,2,0,1,KRÜ Esports,Attack,0,Evil Geniuses,2,24,Evil Geniuses,3,9,-6
155,KRÜ Esports,Evil Geniuses,Evil Geniuses,KRÜ Esports,Ascent,13,11,4,9,0,3,8,0,2,Evil Geniuses,Defense,0,KRÜ Esports,2,24,KRÜ Esports,4,8,-4
155,KRÜ Esports,Evil Geniuses,Evil Geniuses,KRÜ Esports,Fracture,7,13,5,2,0,6,7,0,3,Evil Geniuses,Defense,0,Evil Geniuses,-6,20,,5,7,-2
156,LOUD,FURIA,LOUD,FURIA,Split,13,9,6,7,0,3,6,0,1,FURIA,Defense,0,LOUD,4,22,LOUD,6,6,0
156,FURIA,LOUD,LOUD,FURIA,Icebox,4,13,0,4,0,8,5,0,2,LOUD,Attack,0,LOUD,-9,17,FURIA,4,8,-4
157,LOUD,Sentinels,LOUD,Sentinels,Pearl,6,13,1,5,0,7,6,0,1,Sentinels,Attack,0,Sentinels,-7,19,LOUD,5,7,-2
157,Sentinels,LOUD,LOUD,Sentinels,Haven,11,13,6,5,0,7,6,0,2,LOUD,Attack,0,LOUD,-2,24,Sentinels,5,7,-2
157,Sentinels,LOUD,LOUD,Sentinels,Ascent,8,13,3,5,0,4,9,0,3,LOUD,Defense,0,LOUD,-5,21,,3,9,-6
158,LEVIATÁN,MIBR,LEVIATÁN,MIBR,Pearl,13,4,3,10,0,2,2,0,1,MIBR,Attack,0,LEVIATÁN,9,17,LEVIATÁN,10,2,8
158,MIBR,LEVIATÁN,LEVIATÁN,MIBR,Icebox,3,13,2,1,0,3,10,0,2,LEVIATÁN,Defense,0,LEVIATÁN,-10,16,MIBR,2,10,-8
159,KRÜ Esports,100 Thieves,KRÜ Esports,100 Thieves,Ascent,13,4,4,9,0,3,1,0,1,100 Thieves,Attack,0,KRÜ Esports,9,17,KRÜ Esports,9,3,6
159,100 Thieves,KRÜ Esports,KRÜ Esports,100 Thieves,Split,13,11,4,9,0,3,8,0,2,KRÜ Esports,Defense,0,100 Thieves,2,24,100 Thieves,4,8,-4
159,100 Thieves,KRÜ Esports,KRÜ Esports,100 Thieves,Fracture,13,5,5,8,0,4,1,0,3,KRÜ Esports,Attack,0,100 Thieves,8,18,,8,4,4
160,FURIA,Evil Geniuses,FURIA,Evil Geniuses,Ascent,15,13,5,7,3,5,7,1,1,Evil Geniuses,Defense,1,FURIA,2,28,FURIA,5,7,-2
160,Evil Geniuses,FURIA,FURIA,Evil Geniuses,Fracture,13,7,8,5,0,3,4,0,2,FURIA,Defense,0,Evil Geniuses,6,20,Evil Geniuses,8,4,4
160,Evil Geniuses,FURIA,FURIA,Evil Geniuses,Haven,10,13,7,3,0,8,5,0,3,FURIA,Defense,0,FURIA,-3,23,,7,5,2
161,Cloud9,NRG Esports,Cloud9,NRG Esports,Haven,8,13,5,3,0,9,4,0,1,NRG Esports,Attack,0,NRG Esports,-5,21,Cloud9,3,9,-6
161,NRG Esports,Cloud9,Cloud9,NRG Esports,Pearl,9,13,2,7,0,5,8,0,2,Cloud9,Attack,0,Cloud9,-4,22,NRG Esports,7,5,2
161,NRG Esports,Cloud9,Cloud9,NRG Esports,Ascent,7,13,4,3,0,5,8,0,3,Cloud9,Defense,0,Cloud9,-6,20,,4,8,-4
162,Sentinels,MIBR,Sentinels,MIBR,Pearl,13,5,9,4,0,2,3,0,1,MIBR,Defense,0,Sentinels,8,18,Sentinels,9,3,6
162,MIBR,Sentinels,Sentinels,MIBR,Fracture,6,13,3,3,0,9,4,0,2,Sentinels,Attack,0,Sentinels,-7,19,MIBR,3,9,-6
163,100 Thieves,LEVIATÁN,100 Thieves,LEVIATÁN,Icebox,13,15,5,7,1,5,7,3,1,LEVIATÁN,Defense,1,LEVIATÁN,-2,28,100 Thieves,5,7,-2
163,LEVIATÁN,100 Thieves,100 Thieves,LEVIATÁN,Haven,11,13,5,6,0,6,7,0,2,100 Thieves,Attack,0,100 Thieves,-2,24,LEVIATÁN,6,6,0
163,LEVIATÁN,100 Thieves,100 Thieves,LEVIATÁN,Lotus,11,13,7,4,0,8,5,0,3,100 Thieves,Defense,0,100 Thieves,-2,24,,7,5,2
164,LOUD,Evil Geniuses,LOUD,Evil Geniuses,Split,3,13,0,3,0,9,4,0,1,Evil Geniuses,Attack,0,Evil Geniuses,-10,16,LOUD,3,9,-6
164,Evil Geniuses,LOUD,LOUD,Evil Geniuses,Haven,10,13,6,4,0,8,5,0,2,LOUD,Attack,0,LOUD,-3,23,Evil Geniuses,4,8,-4
164,Evil Geniuses,LOUD,LOUD,Evil Geniuses,Pearl,0,13,0,0,0,12,1,0,3,LOUD,Attack,0,LOUD,-13,13,,0,12,-12
165,FURIA,Cloud9,FURIA,Cloud9,Ascent,8,13,4,4,0,5,8,0,1,Cloud9,Defense,0,Cloud9,-5,21,FURIA,4,8,-4
165,Cloud9,FURIA,FURIA,Cloud9,Fracture,13,9,7,6,0,6,3,0,2,FURIA,Attack,0,Cloud9,4,22,Cloud9,6,6,0
166,NRG Esports,KRÜ Esports,NRG Esports,KRÜ Esports,Haven,13,10,8,5,0,6,4,0,1,KRÜ Esports,Defense,0,NRG Esports,3,23,NRG Esports,8,4,4
166,KRÜ Esports,NRG Esports,NRG Esports,KRÜ Esports,Ascent,4,13,3,1,0,4,9,0,2,NRG Esports,Defense,0,NRG Esports,-9,17,KRÜ Esports,3,9,-6
167,NRG Esports,100 Thieves,NRG Esports,100 Thieves,Bind,13,7,6,7,0,5,2,0,1,100 Thieves,Attack,0,NRG Esports,6,20,NRG Esports,7,5,2
167,100 Thieves,NRG Esports,NRG Esports,100 Thieves,Fracture,3,13,2,1,0,11,2,0,2,NRG Esports,Attack,0,NRG Esports,-10,16,100 Thieves,1,11,-10
168,FURIA,MIBR,FURIA,MIBR,Pearl,13,11,9,4,0,8,3,0,1,MIBR,Attack,0,FURIA,2,24,FURIA,4,8,-4
168,MIBR,FURIA,FURIA,MIBR,Split,7,13,2,5,0,3,10,0,2,FURIA,Defense,0,FURIA,-6,20,MIBR,2,10,-8
169,Sentinels,Cloud9,Sentinels,Cloud9,Lotus,4,13,3,1,0,4,9,0,1,Cloud9,Defense,0,Cloud9,-9,17,Sentinels,3,9,-6
169,Cloud9,Sentinels,Sentinels,Cloud9,Fracture,13,6,2,11,0,1,5,0,2,Sentinels,Attack,0,Cloud9,7,19,Cloud9,11,1,10
170,Evil Geniuses,LEVIATÁN,Evil Geniuses,LEVIATÁN,Split,13,10,4,9,0,2,8,0,1,LEVIATÁN,Defense,0,Evil Geniuses,3,23,Evil Geniuses,4,8,-4
170,LEVIATÁN,Evil Geniuses,Evil Geniuses,LEVIATÁN,Pearl,13,10,7,6,0,6,4,0,2,Evil Geniuses,Attack,0,LEVIATÁN,3,23,LEVIATÁN,6,6,0
170,LEVIATÁN,Evil Geniuses,Evil Geniuses,LEVIATÁN,Ascent,10,13,3,7,0,4,9,0,3,Evil Geniuses,Defense,0,Evil Geniuses,-3,23,,3,9,-6
171,LOUD,KRÜ Esports,LOUD,KRÜ Esports,Pearl,10,13,8,2,0,9,4,0,1,KRÜ Esports,Defense,0,KRÜ Esports,-3,23,LOUD,8,4,4
171,KRÜ Esports,LOUD,LOUD,KRÜ Esports,Ascent,11,13,3,8,0,4,9,0,2,LOUD,Attack,0,LOUD,-2,24,KRÜ Esports,8,4,4
171,KRÜ Esports,LOUD,LOUD,KRÜ Esports,Split,10,13,6,4,0,8,5,0,3,LOUD,Attack,0,LOUD,-3,23,,4,8,-4
172,Evil Geniuses,Sentinels,Evil Geniuses,Sentinels,Fracture,13,6,4,9,0,3,3,0,1,Sentinels,Attack,0,Evil Geniuses,7,19,Evil Geniuses,9,3,6
172,Sentinels,Evil Geniuses,Evil Geniuses,Sentinels,Pearl,5,13,3,2,0,10,3,0,2,Evil Geniuses,Attack,0,Evil Geniuses,-8,18,Sentinels,2,10,-8
173,Cloud9,MIBR,Cloud9,MIBR,Split,13,5,7,6,0,0,5,0,1,MIBR,Defense,0,Cloud9,8,18,Cloud9,7,5,2
173,MIBR,Cloud9,Cloud9,MIBR,Lotus,4,13,4,0,0,5,8,0,2,Cloud9,Defense,0,Cloud9,-9,17,MIBR,4,8,-4
174,LOUD,100 Thieves,LOUD,100 Thieves,Ascent,13,5,8,5,0,1,4,0,1,100 Thieves,Defense,0,LOUD,8,18,LOUD,8,4,4
174,100 Thieves,LOUD,LOUD,100 Thieves,Split,13,15,6,6,1,6,6,3,2,LOUD,Attack,1,LOUD,-2,28,100 Thieves,6,6,0
175,LEVIATÁN,KRÜ Esports,LEVIATÁN,KRÜ Esports,Haven,13,4,11,2,0,3,1,0,1,KRÜ Esports,Defense,0,LEVIATÁN,9,17,LEVIATÁN,11,1,10
175,KRÜ Esports,LEVIATÁN,LEVIATÁN,KRÜ Esports,Split,4,13,3,1,0,4,9,0,2,LEVIATÁN,Defense,0,LEVIATÁN,-9,17,KRÜ Esports,3,9,-6
176,NRG Esports,FURIA,NRG Esports,FURIA,Bind,13,11,10,3,0,9,2,0,1,FURIA,Attack,0,NRG Esports,2,24,NRG Esports,3,9,-6
176,FURIA,NRG Esports,NRG Esports,FURIA,Haven,13,11,7,6,0,6,5,0,2,NRG Esports,Attack,0,FURIA,2,24,FURIA,6,6,0
176,FURIA,NRG Esports,NRG Esports,FURIA,Pearl,6,13,2,4,0,8,5,0,3,NRG Esports,Attack,0,NRG Esports,-7,19,,4,8,-4
177,FURIA,100 Thieves,FURIA,100 Thieves,Pearl,13,10,6,7,0,5,5,0,1,100 Thieves,Attack,0,FURIA,3,23,FURIA,7,5,2
177,100 Thieves,FURIA,FURIA,100 Thieves,Fracture,13,7,10,3,0,5,2,0,2,FURIA,Defense,0,100 Thieves,6,20,100 Thieves,10,2,8
177,100 Thieves,FURIA,FURIA,100 Thieves,Haven,13,11,6,7,0,5,6,0,3,FURIA,Defense,0,100 Thieves,2,24,,6,6,0
178,MIBR,Evil Geniuses,MIBR,Evil Geniuses,Lotus,2,13,2,0,0,3,10,0,1,Evil Geniuses,Defense,0,Evil Geniuses,-11,15,MIBR,2,10,-8
178,Evil Geniuses,MIBR,MIBR,Evil Geniuses,Fracture,13,5,5,8,0,4,1,0,2,MIBR,Attack,0,Evil Geniuses,8,18,Evil Geniuses,8,4,4
179,Sentinels,KRÜ Esports,Sentinels,KRÜ Esports,Lotus,14,12,6,6,2,6,6,0,1,KRÜ Esports,Attack,1,Sentinels,2,26,Sentinels,6,6,0
179,KRÜ Esports,Sentinels,Sentinels,KRÜ Esports,Bind,10,13,4,6,0,5,8,0,2,Sentinels,Defense,0,Sentinels,-3,23,KRÜ Esports,4,8,-4
180,LOUD,NRG Esports,LOUD,NRG Esports,Split,5,13,2,3,0,9,4,0,1,NRG Esports,Attack,0,NRG Esports,-8,18,LOUD,3,9,-6
180,NRG Esports,LOUD,LOUD,NRG Esports,Pearl,13,9,7,6,0,6,3,0,2,LOUD,Attack,0,NRG Esports,4,22,NRG Esports,6,6,0
181,Cloud9,LEVIATÁN,Cloud9,LEVIATÁN,Lotus,13,7,9,4,0,4,3,0,1,LEVIATÁN,Defense,0,Cloud9,6,20,Cloud9,9,3,6
181,LEVIATÁN,Cloud9,Cloud9,LEVIATÁN,Haven,4,13,2,2,0,10,3,0,2,Cloud9,Attack,0,Cloud9,-9,17,LEVIATÁN,2,10,-8
182,Sentinels,FURIA,Sentinels,FURIA,Split,13,7,9,4,0,4,3,0,1,FURIA,Defense,0,Sentinels,6,20,Sentinels,9,3,6
182,FURIA,Sentinels,Sentinels,FURIA,Haven,13,5,8,5,0,1,4,0,2,Sentinels,Defense,0,FURIA,8,18,FURIA,8,4,4
182,FURIA,Sentinels,Sentinels,FURIA,Bind,17,19,6,6,5,6,6,7,3,Sentinels,Defense,1,Sentinels,-2,36,,6,6,0
183,NRG Esports,Evil Geniuses,NRG Esports,Evil Geniuses,Bind,13,9,4,9,0,1,8,0,1,Evil Geniuses,Defense,0,NRG Esports,4,22,NRG Esports,4,8,-4
183,Evil Geniuses,NRG Esports,NRG Esports,Evil Geniuses,Split,7,13,2,5,0,7,6,0,2,NRG Esports,Attack,0,NRG Esports,-6,20,Evil Geniuses,5,7,-2
184,Cloud9,KRÜ Esports,Cloud9,KRÜ Esports,Lotus,15,13,9,3,3,9,3,1,1,KRÜ Esports,Attack,1,Cloud9,2,28,Cloud9,3,9,-6
184,KRÜ Esports,Cloud9,Cloud9,KRÜ Esports,Ascent,13,6,6,7,0,0,6,0,2,Cloud9,Defense,0,KRÜ Esports,7,19,KRÜ Esports,6,6,0
184,KRÜ Esports,Cloud9,Cloud9,KRÜ Esports,Split,9,13,5,4,0,8,5,0,3,Cloud9,Attack,0,Cloud9,-4,22,,4,8,-4
185,LEVIATÁN,LOUD,LEVIATÁN,LOUD,Haven,7,13,3,4,0,8,5,0,1,LOUD,Attack,0,LOUD,-6,20,LEVIATÁN,4,8,-4
185,LOUD,LEVIATÁN,LEVIATÁN,LOUD,Ascent,13,5,9,4,0,2,3,0,2,LEVIATÁN,Defense,0,LOUD,8,18,LOUD,9,3,6
186,100 Thieves,MIBR,100 Thieves,MIBR,Fracture,6,13,2,4,0,8,5,0,1,MIBR,Attack,0,MIBR,-7,19,100 Thieves,4,8,-4
186,MIBR,100 Thieves,100 Thieves,MIBR,Pearl,12,14,4,8,0,4,8,2,2,100 Thieves,Attack,1,100 Thieves,-2,26,MIBR,8,4,4
186,MIBR,100 Thieves,100 Thieves,MIBR,Lotus,13,7,6,7,0,5,2,0,3,100 Thieves,Attack,0,MIBR,6,20,,7,5,2
187,FURIA,LEVIATÁN,FURIA,LEVIATÁN,Ascent,13,5,8,5,0,1,4,0,1,LEVIATÁN,Defense,0,FURIA,8,18,FURIA,8,4,4
187,LEVIATÁN,FURIA,FURIA,LEVIATÁN,Pearl,20,18,8,4,8,8,4,6,2,FURIA,Attack,1,LEVIATÁN,2,38,LEVIATÁN,4,8,-4
187,LEVIATÁN,FURIA,FURIA,LEVIATÁN,Bind,6,13,1,5,0,7,6,0,3,FURIA,Attack,0,FURIA,-7,19,,5,7,-2
188,NRG Esports,Evil Geniuses,NRG Esports,Evil Geniuses,Haven,13,11,6,7,0,5,6,0,1,Evil Geniuses,Defense,0,NRG Esports,2,24,NRG Esports,6,6,0
188,Evil Geniuses,NRG Esports,NRG Esports,Evil Geniuses,Split,15,13,4,8,3,4,8,1,2,NRG Esports,Attack,1,Evil Geniuses,2,28,Evil Geniuses,8,4,4
188,Evil Geniuses,NRG Esports,NRG Esports,Evil Geniuses,Ascent,13,7,7,6,0,2,5,0,3,NRG Esports,Defense,0,Evil Geniuses,6,20,,7,5,2
189,FURIA,LOUD,FURIA,LOUD,Haven,4,13,1,3,0,9,4,0,1,LOUD,Attack,0,LOUD,-9,17,FURIA,3,9,-6
189,LOUD,FURIA,FURIA,LOUD,Ascent,13,5,9,4,0,2,3,0,2,FURIA,Defense,0,LOUD,8,18,LOUD,9,3,6
190,Evil Geniuses,Cloud9,Evil Geniuses,Cloud9,Fracture,13,5,5,8,0,4,1,0,1,Cloud9,Attack,0,Evil Geniuses,8,18,Evil Geniuses,8,4,4
190,Cloud9,Evil Geniuses,Evil Geniuses,Cloud9,Bind,2,13,2,0,0,3,10,0,2,Evil Geniuses,Defense,0,Evil Geniuses,-11,15,Cloud9,2,10,-8
191,NRG Esports,FURIA,NRG Esports,FURIA,Bind,13,9,3,10,0,2,7,0,1,FURIA,Attack,0,NRG Esports,4,22,NRG Esports,10,2,8
191,FURIA,NRG Esports,NRG Esports,FURIA,Haven,10,13,3,7,0,5,8,0,2,NRG Esports,Attack,0,NRG Esports,-3,23,FURIA,7,5,2
192,LEVIATÁN,Cloud9,LEVIATÁN,Cloud9,Haven,8,13,5,3,0,9,4,0,1,Cloud9,Attack,0,Cloud9,-5,21,LEVIATÁN,3,9,-6
192,Cloud9,LEVIATÁN,LEVIATÁN,Cloud9,Lotus,10,13,6,4,0,7,6,0,2,LEVIATÁN,Defense,0,LEVIATÁN,-3,23,Cloud9,6,6,0
192,Cloud9,LEVIATÁN,LEVIATÁN,Cloud9,Ascent,13,4,8,5,0,0,4,0,3,LEVIATÁN,Defense,0,Cloud9,9,17,,8,4,4
193,Evil Geniuses,LOUD,Evil Geniuses,LOUD,Fracture,9,13,4,5,0,7,6,0,1,LOUD,Attack,0,LOUD,-4,22,Evil Geniuses,5,7,-2
193,LOUD,Evil Geniuses,Evil Geniuses,LOUD,Ascent,11,13,7,4,0,8,5,0,2,Evil Geniuses,Defense,0,Evil Geniuses,-2,24,LOUD,7,5,2
193,LOUD,Evil Geniuses,Evil Geniuses,LOUD,Bind,13,3,10,3,0,1,2,0,3,Evil Geniuses,Defense,0,LOUD,10,16,,10,2,8
194,NRG Esports,Cloud9,NRG Esports,Cloud9,Pearl,10,13,3,7,0,5,8,0,1,Cloud9,Attack,0,Cloud9,-3,23,NRG Esports,7,5,2
194,Cloud9,NRG Esports,NRG Esports,Cloud9,Lotus,9,13,4,5,0,7,6,0,2,NRG Esports,Attack,0,NRG Esports,-4,22,Cloud9,5,7,-2
194,Cloud9,NRG Esports,NRG Esports,Cloud9,Haven,12,14,6,6,0,6,6,2,3,NRG Esports,Attack,1,NRG Esports,-2,26,,6,6,0
195,NRG Esports,Evil Geniuses,NRG Esports,Evil Geniuses,Haven,11,13,5,6,0,6,7,0,1,Evil Geniuses,Defense,0,Evil Geniuses,-2,24,NRG Esports,5,7,-2
195,Evil Geniuses,NRG Esports,NRG Esports,Evil Geniuses,Ascent,8,13,3,5,0,4,9,0,2,NRG Esports,Defense,0,NRG Esports,-5,21,Evil Geniuses,3,9,-6
195,NRG Esports,Evil Geniuses,NRG Esports,Evil Geniuses,Lotus,13,10,5,8,0,3,7,0,3,Evil Geniuses,Defense,0,NRG Esports,3,23,NRG Esports,5,7,-2
195,Evil Geniuses,NRG Esports,NRG Esports,Evil Geniuses,Split,4,13,3,1,0,11,2,0,4,NRG Esports,Attack,0,NRG Esports,-9,17,Evil Geniuses,1,11,-10
196,LOUD,NRG Esports,LOUD,NRG Esports,Ascent,13,9,5,8,0,2,7,0,1,NRG Esports,Defense,0,LOUD,4,22,LOUD,5,7,-2
196,NRG Esports,LOUD,LOUD,NRG Esports,Bind,11,13,6,5,0,7,6,0,2,LOUD,Defense,0,LOUD,-2,24,NRG Esports,6,6,0
196,LOUD,NRG Esports,LOUD,NRG Esports,Fracture,13,11,8,5,0,7,4,0,3,NRG Esports,Attack,0,LOUD,2,24,LOUD,5,7,-2
197,Weibo Gaming,Totoro Gaming,Weibo Gaming,Totoro Gaming,Haven,13,15,4,8,1,4,8,3,1,Totoro Gaming,Defense,1,Totoro Gaming,-2,28,Weibo Gaming,4,8,-4
197,Totoro Gaming,Weibo Gaming,Weibo Gaming,Totoro Gaming,Split,13,11,9,4,0,8,3,0,2,Weibo Gaming,Defense,0,Totoro Gaming,2,24,Totoro Gaming,9,3,6
199,Royal Never Give Up,Gank Gaming,Royal Never Give Up,Gank Gaming,Ascent,13,6,6,7,0,0,6,0,1,Gank Gaming,Defense,0,Royal Never Give Up,7,19,Royal Never Give Up,6,6,0
199,Gank Gaming,Royal Never Give Up,Royal Never Give Up,Gank Gaming,Lotus,13,10,5,8,0,4,6,0,2,Royal Never Give Up,Attack,0,Gank Gaming,3,23,Gank Gaming,8,4,4
199,Gank Gaming,Royal Never Give Up,Royal Never Give Up,Gank Gaming,Bind,11,13,5,6,0,6,7,0,3,Royal Never Give Up,Attack,0,Royal Never Give Up,-2,24,,6,6,0
202,TYLOO,Monarch Effect,TYLOO,Monarch Effect,Lotus,16,14,7,5,4,7,5,2,1,Monarch Effect,Defense,1,TYLOO,2,30,TYLOO,7,5,2
202,Monarch Effect,TYLOO,TYLOO,Monarch Effect,Ascent,13,8,9,4,0,5,3,0,2,TYLOO,Defense,0,Monarch Effect,5,21,Monarch Effect,9,3,6
202,Monarch Effect,TYLOO,TYLOO,Monarch Effect,Split,11,13,9,2,0,10,3,0,3,TYLOO,Defense,0,TYLOO,-2,24,,9,3,6
204,Rare Atom,Dragon Ranger Gaming,Rare Atom,Dragon Ranger Gaming,Haven,7,13,2,5,0,7,6,0,1,Dragon Ranger Gaming,Attack,0,Dragon Ranger Gaming,-6,20,Rare Atom,5,7,-2
204,Dragon Ranger Gaming,Rare Atom,Rare Atom,Dragon Ranger Gaming,Lotus,12,14,8,4,0,8,4,2,2,Rare Atom,Attack,1,Rare Atom,-2,26,Dragon Ranger Gaming,4,8,-4
204,Dragon Ranger Gaming,Rare Atom,Rare Atom,Dragon Ranger Gaming,Ascent,13,11,7,6,0,6,5,0,3,Rare Atom,Defense,0,Dragon Ranger Gaming,2,24,,7,5,2
205,Shenzhen NTER,Totoro Gaming,Shenzhen NTER,Totoro Gaming,Lotus,4,13,1,3,0,9,4,0,1,Totoro Gaming,Attack,0,Totoro Gaming,-9,17,Shenzhen NTER,3,9,-6
205,Totoro Gaming,Shenzhen NTER,Shenzhen NTER,Totoro Gaming,Ascent,21,19,3,9,9,3,9,7,2,Shenzhen NTER,Defense,1,Totoro Gaming,2,40,Totoro Gaming,3,9,-6
207,Nova Esports,TYLOO,Nova Esports,TYLOO,Split,7,13,6,1,0,7,6,0,1,TYLOO,Defense,0,TYLOO,-6,20,Nova Esports,6,6,0
207,TYLOO,Nova Esports,Nova Esports,TYLOO,Bind,13,5,9,4,0,2,3,0,2,Nova Esports,Defense,0,TYLOO,8,18,TYLOO,9,3,6
209,Gank Gaming,Invincible Gaming,Gank Gaming,Invincible Gaming,Lotus,16,14,5,7,4,5,7,2,1,Invincible Gaming,Attack,1,Gank Gaming,2,30,Gank Gaming,7,5,2
209,Invincible Gaming,Gank Gaming,Gank Gaming,Invincible Gaming,Split,4,13,2,2,0,3,10,0,2,Gank Gaming,Defense,0,Gank Gaming,-9,17,Invincible Gaming,2,10,-8
212,Rare Atom,Monarch Effect,Rare Atom,Monarch Effect,Lotus,14,12,6,6,2,6,6,0,1,Monarch Effect,Defense,1,Rare Atom,2,26,Rare Atom,6,6,0
212,Monarch Effect,Rare Atom,Rare Atom,Monarch Effect,Ascent,13,8,7,6,0,3,5,0,2,Rare Atom,Defense,0,Monarch Effect,5,21,Monarch Effect,7,5,2
212,Monarch Effect,Rare Atom,Rare Atom,Monarch Effect,Bind,13,11,6,7,0,5,6,0,3,Rare Atom,Attack,0,Monarch Effect,2,24,,7,5,2
213,Shenzhen NTER,Weibo Gaming,Shenzhen NTER,Weibo Gaming,Fracture,10,13,7,3,0,9,4,0,1,Weibo Gaming,Attack,0,Weibo Gaming,-3,23,Shenzhen NTER,3,9,-6
213,Weibo Gaming,Shenzhen NTER,Shenzhen NTER,Weibo Gaming,Haven,13,11,8,5,0,7,4,0,2,Shenzhen NTER,Attack,0,Weibo Gaming,2,24,Weibo Gaming,5,7,-2
215,Night Wings Gaming,Gank Gaming,Night Wings Gaming,Gank Gaming,Split,13,11,8,5,0,7,4,0,1,Gank Gaming,Defense,0,Night Wings Gaming,2,24,Night Wings Gaming,8,4,4
215,Gank Gaming,Night Wings Gaming,Night Wings Gaming,Gank Gaming,Bind,12,14,7,5,0,7,5,2,2,Night Wings Gaming,Defense,1,Night Wings Gaming,-2,26,Gank Gaming,7,5,2
217,Douyu Gaming,Totoro Gaming,Douyu Gaming,Totoro Gaming,Ascent,4,13,2,2,0,3,10,0,1,Totoro Gaming,Defense,0,Totoro Gaming,-9,17,Douyu Gaming,2,10,-8
217,Totoro Gaming,Douyu Gaming,Douyu Gaming,Totoro Gaming,Pearl,13,10,5,8,0,3,7,0,2,Douyu Gaming,Defense,0,Totoro Gaming,3,23,Totoro Gaming,5,7,-2
220,TYLOO,Dragon Ranger Gaming,TYLOO,Dragon Ranger Gaming,Bind,13,7,5,8,0,4,3,0,1,Dragon Ranger Gaming,Attack,0,TYLOO,6,20,TYLOO,8,4,4
220,Dragon Ranger Gaming,TYLOO,TYLOO,Dragon Ranger Gaming,Ascent,9,13,6,3,0,7,6,0,2,TYLOO,Defense,0,TYLOO,-4,22,Dragon Ranger Gaming,6,6,0
221,Weibo Gaming,Night Wings Gaming,Weibo Gaming,Night Wings Gaming,Haven,13,5,3,10,0,2,3,0,1,Night Wings Gaming,Attack,0,Weibo Gaming,8,18,Weibo Gaming,10,2,8
221,Night Wings Gaming,Weibo Gaming,Weibo Gaming,Night Wings Gaming,Lotus,9,13,7,2,0,10,3,0,2,Weibo Gaming,Attack,0,Weibo Gaming,-4,22,Night Wings Gaming,2,10,-8
223,Royal Never Give Up,Douyu Gaming,Royal Never Give Up,Douyu Gaming,Bind,14,12,10,2,2,10,2,0,1,Douyu Gaming,Defense,1,Royal Never Give Up,2,26,Royal Never Give Up,10,2,8
223,Douyu Gaming,Royal Never Give Up,Royal Never Give Up,Douyu Gaming,Split,11,13,3,8,0,4,9,0,2,Royal Never Give Up,Attack,0,Royal Never Give Up,-2,24,Douyu Gaming,8,4,4
225,Monarch Effect,Dragon Ranger Gaming,Monarch Effect,Dragon Ranger Gaming,Ascent,13,8,8,5,0,4,4,0,1,Dragon Ranger Gaming,Defense,0,Monarch Effect,5,21,Monarch Effect,8,4,4
225,Dragon Ranger Gaming,Monarch Effect,Monarch Effect,Dragon Ranger Gaming,Pearl,13,7,7,6,0,2,5,0,2,Monarch Effect,Defense,0,Dragon Ranger Gaming,6,20,Dragon Ranger Gaming,7,5,2
225,Dragon Ranger Gaming,Monarch Effect,Monarch Effect,Dragon Ranger Gaming,Split,9,13,5,4,0,6,7,0,3,Monarch Effect,Defense,0,Monarch Effect,-4,22,,5,7,-2
227,Night Wings Gaming,Shenzhen NTER,Night Wings Gaming,Shenzhen NTER,Split,8,13,5,3,0,6,7,0,1,Shenzhen NTER,Defense,0,Shenzhen NTER,-5,21,Night Wings Gaming,5,7,-2
227,Shenzhen NTER,Night Wings Gaming,Night Wings Gaming,Shenzhen NTER,Haven,9,13,5,4,0,8,5,0,2,Night Wings Gaming,Attack,0,Night Wings Gaming,-4,22,Shenzhen NTER,4,8,-4
227,Shenzhen NTER,Night Wings Gaming,Night Wings Gaming,Shenzhen NTER,Ascent,15,13,6,6,3,6,6,1,3,Night Wings Gaming,Defense,1,Shenzhen NTER,2,28,,6,6,0
228,Four Angry Men,Gank Gaming,Four Angry Men,Gank Gaming,Bind,11,13,4,7,0,5,8,0,1,Gank Gaming,Attack,0,Gank Gaming,-2,24,Four Angry Men,7,5,2
228,Gank Gaming,Four Angry Men,Four Angry Men,Gank Gaming,Haven,1,13,0,1,0,11,2,0,2,Four Angry Men,Attack,0,Four Angry Men,-12,14,Gank Gaming,1,11,-10
228,Gank Gaming,Four Angry Men,Four Angry Men,Gank Gaming,Ascent,16,18,8,4,4,8,4,6,3,Four Angry Men,Attack,1,Four Angry Men,-2,34,,4,8,-4
229,Douyu Gaming,Dragon Ranger Gaming,Douyu Gaming,Dragon Ranger Gaming,Haven,11,13,6,5,0,7,6,0,1,Dragon Ranger Gaming,Attack,0,Dragon Ranger Gaming,-2,24,Douyu Gaming,5,7,-2
229,Dragon Ranger Gaming,Douyu Gaming,Douyu Gaming,Dragon Ranger Gaming,Lotus,13,5,9,4,0,2,3,0,2,Douyu Gaming,Defense,0,Dragon Ranger Gaming,8,18,Dragon Ranger Gaming,9,3,6
230,Four Angry Men,Trace Esports,Four Angry Men,Trace Esports,Haven,9,13,7,2,0,10,3,0,1,Trace Esports,Attack,0,Trace Esports,-4,22,Four Angry Men,2,10,-8
230,Trace Esports,Four Angry Men,Four Angry Men,Trace Esports,Lotus,18,16,6,6,6,6,6,4,2,Four Angry Men,Defense,1,Trace Esports,2,34,Trace Esports,6,6,0
231,Royal Never Give Up,Monarch Effect,Royal Never Give Up,Monarch Effect,Bind,11,13,4,7,0,5,8,0,1,Monarch Effect,Defense,0,Monarch Effect,-2,24,Royal Never Give Up,4,8,-4
231,Monarch Effect,Royal Never Give Up,Royal Never Give Up,Monarch Effect,Haven,6,13,4,2,0,10,3,0,2,Royal Never Give Up,Attack,0,Royal Never Give Up,-7,19,Monarch Effect,2,10,-8
231,Monarch Effect,Royal Never Give Up,Royal Never Give Up,Monarch Effect,Split,13,2,3,10,0,2,0,0,3,Royal Never Give Up,Attack,0,Monarch Effect,11,15,,10,2,8
232,TYLOO,Shenzhen NTER,TYLOO,Shenzhen NTER,Pearl,13,4,4,9,0,3,1,0,1,Shenzhen NTER,Attack,0,TYLOO,9,17,TYLOO,9,3,6
232,Shenzhen NTER,TYLOO,TYLOO,Shenzhen NTER,Lotus,9,13,1,8,0,4,9,0,2,TYLOO,Attack,0,TYLOO,-4,22,Shenzhen NTER,8,4,4
233,Weibo Gaming,Dragon Ranger Gaming,Weibo Gaming,Dragon Ranger Gaming,Haven,10,13,4,6,0,6,7,0,1,Dragon Ranger Gaming,Attack,0,Dragon Ranger Gaming,-3,23,Weibo Gaming,6,6,0
233,Dragon Ranger Gaming,Weibo Gaming,Weibo Gaming,Dragon Ranger Gaming,Bind,9,13,6,3,0,7,6,0,2,Weibo Gaming,Defense,0,Weibo Gaming,-4,22,Dragon Ranger Gaming,6,6,0
233,Dragon Ranger Gaming,Weibo Gaming,Weibo Gaming,Dragon Ranger Gaming,Split,5,13,4,1,0,5,8,0,3,Weibo Gaming,Defense,0,Weibo Gaming,-8,18,,4,8,-4
234,Attacking Soul Esports,Trace Esports,Attacking Soul Esports,Trace Esports,Lotus,13,10,7,6,0,6,4,0,1,Trace Esports,Attack,0,Attacking Soul Esports,3,23,Attacking Soul Esports,6,6,0
234,Trace Esports,Attacking Soul Esports,Attacking Soul Esports,Trace Esports,Split,13,5,8,5,0,1,4,0,2,Attacking Soul Esports,Defense,0,Trace Esports,8,18,Trace Esports,8,4,4
234,Trace Esports,Attacking Soul Esports,Attacking Soul Esports,Trace Esports,Bind,13,11,10,3,0,9,2,0,3,Attacking Soul Esports,Defense,0,Trace Esports,2,24,,10,2,8
235,Bilibili Gaming,Monarch Effect,Bilibili Gaming,Monarch Effect,Lotus,13,10,10,3,0,9,1,0,1,Monarch Effect,Attack,0,Bilibili Gaming,3,23,Bilibili Gaming,3,9,-6
235,Monarch Effect,Bilibili Gaming,Bilibili Gaming,Monarch Effect,Haven,7,13,3,4,0,4,9,0,2,Bilibili Gaming,Defense,0,Bilibili Gaming,-6,20,Monarch Effect,3,9,-6
236,FunPlus Phoenix,TYLOO,FunPlus Phoenix,TYLOO,Fracture,9,13,4,5,0,7,6,0,1,TYLOO,Attack,0,TYLOO,-4,22,FunPlus Phoenix,5,7,-2
236,TYLOO,FunPlus Phoenix,FunPlus Phoenix,TYLOO,Bind,13,10,8,5,0,6,4,0,2,FunPlus Phoenix,Defense,0,TYLOO,3,23,TYLOO,8,4,4
237,Weibo Gaming,EDward Gaming,Weibo Gaming,EDward Gaming,Fracture,6,13,2,4,0,8,5,0,1,EDward Gaming,Attack,0,EDward Gaming,-7,19,Weibo Gaming,4,8,-4
237,EDward Gaming,Weibo Gaming,Weibo Gaming,EDward Gaming,Bind,13,7,9,4,0,4,3,0,2,Weibo Gaming,Defense,0,EDward Gaming,6,20,EDward Gaming,9,3,6
238,Attacking Soul Esports,Monarch Effect,Attacking Soul Esports,Monarch Effect,Fracture,13,5,8,5,0,1,4,0,1,Monarch Effect,Defense,0,Attacking Soul Esports,8,18,Attacking Soul Esports,8,4,4
238,Monarch Effect,Attacking Soul Esports,Attacking Soul Esports,Monarch Effect,Split,5,13,3,2,0,4,9,0,2,Attacking Soul Esports,Defense,0,Attacking Soul Esports,-8,18,Monarch Effect,3,9,-6
239,FunPlus Phoenix,Weibo Gaming,FunPlus Phoenix,Weibo Gaming,Lotus,13,5,4,9,0,3,2,0,1,Weibo Gaming,Attack,0,FunPlus Phoenix,8,18,FunPlus Phoenix,9,3,6
239,Weibo Gaming,FunPlus Phoenix,FunPlus Phoenix,Weibo Gaming,Ascent,9,13,7,2,0,8,5,0,2,FunPlus Phoenix,Defense,0,FunPlus Phoenix,-4,22,Weibo Gaming,7,5,2
240,Bilibili Gaming,Trace Esports,Bilibili Gaming,Trace Esports,Haven,13,10,7,6,0,6,4,0,1,Trace Esports,Attack,0,Bilibili Gaming,3,23,Bilibili Gaming,6,6,0
240,Trace Esports,Bilibili Gaming,Bilibili Gaming,Trace Esports,Lotus,5,13,1,4,0,2,11,0,2,Bilibili Gaming,Defense,0,Bilibili Gaming,-8,18,Trace Esports,1,11,-10
240,Bilibili Gaming,Trace Esports,Bilibili Gaming,Trace Esports,Split,13,2,10,3,0,0,2,0,3,Trace Esports,Defense,0,Bilibili Gaming,11,15,Bilibili Gaming,10,2,8
241,TYLOO,EDward Gaming,TYLOO,EDward Gaming,Split,6,13,4,2,0,5,8,0,1,EDward Gaming,Defense,0,EDward Gaming,-7,19,TYLOO,4,8,-4
241,EDward Gaming,TYLOO,TYLOO,EDward Gaming,Haven,13,2,3,10,0,2,0,0,2,TYLOO,Attack,0,EDward Gaming,11,15,EDward Gaming,10,2,8
241,TYLOO,EDward Gaming,TYLOO,EDward Gaming,Bind,2,13,0,2,0,10,3,0,3,EDward Gaming,Attack,0,EDward Gaming,-11,15,TYLOO,2,10,-8
242,FunPlus Phoenix,Trace Esports,FunPlus Phoenix,Trace Esports,Lotus,13,9,6,7,0,5,4,0,1,Trace Esports,Attack,0,FunPlus Phoenix,4,22,FunPlus Phoenix,7,5,2
242,Trace Esports,FunPlus Phoenix,FunPlus Phoenix,Trace Esports,Split,13,6,8,5,0,2,4,0,2,FunPlus Phoenix,Defense,0,Trace Esports,7,19,Trace Esports,8,4,4
242,Trace Esports,FunPlus Phoenix,FunPlus Phoenix,Trace Esports,Ascent,8,13,3,5,0,7,6,0,3,FunPlus Phoenix,Attack,0,FunPlus Phoenix,-5,21,,5,7,-2
243,TYLOO,Attacking Soul Esports,TYLOO,Attacking Soul Esports,Split,3,13,2,1,0,3,10,0,1,Attacking Soul Esports,Defense,0,Attacking Soul Esports,-10,16,TYLOO,2,10,-8
243,Attacking Soul Esports,TYLOO,TYLOO,Attacking Soul Esports,Fracture,10,13,5,5,0,7,6,0,2,TYLOO,Attack,0,TYLOO,-3,23,Attacking Soul Esports,5,7,-2
243,Attacking Soul Esports,TYLOO,TYLOO,Attacking Soul Esports,Ascent,12,14,5,7,0,5,7,2,3,TYLOO,Defense,1,TYLOO,-2,26,,5,7,-2
244,Bilibili Gaming,EDward Gaming,Bilibili Gaming,EDward Gaming,Pearl,3,13,0,3,0,9,4,0,1,EDward Gaming,Attack,0,EDward Gaming,-10,16,Bilibili Gaming,3,9,-6
244,EDward Gaming,Bilibili Gaming,Bilibili Gaming,EDward Gaming,Bind,13,10,6,7,0,4,6,0,2,Bilibili Gaming,Defense,0,EDward Gaming,3,23,EDward Gaming,6,6,0
244,Bilibili Gaming,EDward Gaming,Bilibili Gaming,EDward Gaming,Split,4,13,4,0,0,5,8,0,3,EDward Gaming,Defense,0,EDward Gaming,-9,17,Bilibili Gaming,4,8,-4
245,FunPlus Phoenix,TYLOO,FunPlus Phoenix,TYLOO,Pearl,13,8,8,5,0,4,4,0,1,TYLOO,Defense,0,FunPlus Phoenix,5,21,FunPlus Phoenix,8,4,4
245,TYLOO,FunPlus Phoenix,FunPlus Phoenix,TYLOO,Bind,13,7,5,8,0,4,3,0,2,FunPlus Phoenix,Attack,0,TYLOO,6,20,TYLOO,8,4,4
245,FunPlus Phoenix,TYLOO,FunPlus Phoenix,TYLOO,Ascent,13,11,8,5,0,7,4,0,3,TYLOO,Defense,0,FunPlus Phoenix,2,24,FunPlus Phoenix,8,4,4
245,TYLOO,FunPlus Phoenix,FunPlus Phoenix,TYLOO,Fracture,10,13,4,6,0,6,7,0,4,FunPlus Phoenix,Attack,0,FunPlus Phoenix,-3,23,TYLOO,6,6,0
246,FunPlus Phoenix,Bilibili Gaming,FunPlus Phoenix,Bilibili Gaming,Lotus,13,11,8,5,0,7,4,0,1,Bilibili Gaming,Defense,0,FunPlus Phoenix,2,24,FunPlus Phoenix,8,4,4
246,Bilibili Gaming,FunPlus Phoenix,FunPlus Phoenix,Bilibili Gaming,Bind,13,9,5,8,0,4,5,0,2,FunPlus Phoenix,Attack,0,Bilibili Gaming,4,22,Bilibili Gaming,8,4,4
246,FunPlus Phoenix,Bilibili Gaming,FunPlus Phoenix,Bilibili Gaming,Pearl,13,9,8,5,0,5,4,0,3,Bilibili Gaming,Defense,0,FunPlus Phoenix,4,22,FunPlus Phoenix,8,4,4
246,Bilibili Gaming,FunPlus Phoenix,FunPlus Phoenix,Bilibili Gaming,Split,13,6,4,9,0,3,3,0,4,FunPlus Phoenix,Attack,0,Bilibili Gaming,7,19,Bilibili Gaming,9,3,6
246,FunPlus Phoenix,Bilibili Gaming,FunPlus Phoenix,Bilibili Gaming,Ascent,5,13,2,3,0,3,10,0,5,Bilibili Gaming,Defense,0,Bilibili Gaming,-8,18,,2,10,-8
247,Bilibili Gaming,EDward Gaming,Bilibili Gaming,EDward Gaming,Split,6,13,3,3,0,4,9,0,1,EDward Gaming,Defense,0,EDward Gaming,-7,19,Bilibili Gaming,3,9,-6
247,EDward Gaming,Bilibili Gaming,Bilibili Gaming,EDward Gaming,Fracture,13,4,5,8,0,4,0,0,2,Bilibili Gaming,Attack,0,EDward Gaming,9,17,EDward Gaming,8,4,4
247,Bilibili Gaming,EDward Gaming,Bilibili Gaming,EDward Gaming,Bind,14,12,8,4,2,8,4,0,3,EDward Gaming,Attack,1,Bilibili Gaming,2,26,Bilibili Gaming,4,8,-4
247,EDward Gaming,Bilibili Gaming,Bilibili Gaming,EDward Gaming,Haven,14,12,4,8,2,4,8,0,4,Bilibili Gaming,Defense,1,EDward Gaming,2,26,EDward Gaming,4,8,-4
248,Evil Geniuses,FUT Esports,Evil Geniuses,FUT Esports,Split,13,5,7,6,0,0,5,0,1,FUT Esports,Defense,0,Evil Geniuses,8,18,Evil Geniuses,7,5,2
248,FUT Esports,Evil Geniuses,Evil Geniuses,FUT Esports,Lotus,12,14,6,6,0,6,6,2,2,Evil Geniuses,Defense,1,Evil Geniuses,-2,26,FUT Esports,6,6,0
249,Attacking Soul Esports,DRX,Attacking Soul Esports,DRX,Fracture,10,13,5,5,0,7,6,0,1,DRX,Attack,0,DRX,-3,23,Attacking Soul Esports,5,7,-2
249,DRX,Attacking Soul Esports,Attacking Soul Esports,DRX,Pearl,13,7,8,5,0,3,4,0,2,Attacking Soul Esports,Defense,0,DRX,6,20,DRX,8,4,4
250,T1,EDward Gaming,T1,EDward Gaming,Fracture,13,10,7,6,0,6,4,0,1,EDward Gaming,Attack,0,T1,3,23,T1,6,6,0
250,EDward Gaming,T1,T1,EDward Gaming,Haven,13,7,6,7,0,1,6,0,2,T1,Defense,0,EDward Gaming,6,20,EDward Gaming,6,6,0
250,EDward Gaming,T1,T1,EDward Gaming,Pearl,12,14,6,6,0,6,6,2,3,T1,Defense,1,T1,-2,26,,6,6,0
251,Natus Vincere,NRG Esports,Natus Vincere,NRG Esports,Ascent,8,13,6,2,0,7,6,0,1,NRG Esports,Defense,0,NRG Esports,-5,21,Natus Vincere,6,6,0
251,NRG Esports,Natus Vincere,Natus Vincere,NRG Esports,Lotus,12,14,8,4,0,8,4,2,2,Natus Vincere,Defense,1,Natus Vincere,-2,26,NRG Esports,8,4,4
251,NRG Esports,Natus Vincere,Natus Vincere,NRG Esports,Split,13,6,10,3,0,4,2,0,3,Natus Vincere,Defense,0,NRG Esports,7,19,,10,2,8
252,Evil Geniuses,DRX,Evil Geniuses,DRX,Fracture,13,5,5,8,0,4,1,0,1,DRX,Attack,0,Evil Geniuses,8,18,Evil Geniuses,8,4,4
252,DRX,Evil Geniuses,Evil Geniuses,DRX,Ascent,9,13,5,4,0,6,7,0,2,Evil Geniuses,Defense,0,Evil Geniuses,-4,22,DRX,5,7,-2
253,T1,NRG Esports,T1,NRG Esports,Lotus,13,11,7,6,0,6,5,0,1,NRG Esports,Attack,0,T1,2,24,T1,6,6,0
253,NRG Esports,T1,T1,NRG Esports,Bind,13,7,6,7,0,1,6,0,2,T1,Defense,0,NRG Esports,6,20,NRG Esports,6,6,0
253,NRG Esports,T1,T1,NRG Esports,Pearl,13,11,7,6,0,6,5,0,3,T1,Defense,0,NRG Esports,2,24,,7,5,2
254,FUT Esports,Attacking Soul Esports,FUT Esports,Attacking Soul Esports,Haven,8,13,3,5,0,4,9,0,1,Attacking Soul Esports,Defense,0,Attacking Soul Esports,-5,21,FUT Esports,3,9,-6
254,Attacking Soul Esports,FUT Esports,FUT Esports,Attacking Soul Esports,Ascent,5,13,5,0,0,6,7,0,2,FUT Esports,Defense,0,FUT Esports,-8,18,Attacking Soul Esports,5,7,-2
254,Attacking Soul Esports,FUT Esports,FUT Esports,Attacking Soul Esports,Lotus,6,13,2,4,0,8,5,0,3,FUT Esports,Attack,0,FUT Esports,-7,19,,4,8,-4
255,Natus Vincere,EDward Gaming,Natus Vincere,EDward Gaming,Pearl,15,17,7,5,3,7,5,5,1,EDward Gaming,Attack,1,EDward Gaming,-2,32,Natus Vincere,5,7,-2
255,EDward Gaming,Natus Vincere,Natus Vincere,EDward Gaming,Bind,14,12,6,6,2,6,6,0,2,Natus Vincere,Defense,1,EDward Gaming,2,26,EDward Gaming,6,6,0
256,FUT Esports,DRX,FUT Esports,DRX,Bind,13,9,4,9,0,3,6,0,1,DRX,Attack,0,FUT Esports,4,22,FUT Esports,9,3,6
256,DRX,FUT Esports,FUT Esports,DRX,Fracture,13,8,7,6,0,6,2,0,2,FUT Esports,Attack,0,DRX,5,21,DRX,6,6,0
256,DRX,FUT Esports,FUT Esports,DRX,Haven,13,4,2,11,0,1,3,0,3,FUT Esports,Attack,0,DRX,9,17,,11,1,10
257,T1,EDward Gaming,T1,EDward Gaming,Fracture,4,13,0,4,0,8,5,0,1,EDward Gaming,Attack,0,EDward Gaming,-9,17,T1,4,8,-4
257,EDward Gaming,T1,T1,EDward Gaming,Haven,13,6,10,3,0,4,2,0,2,T1,Defense,0,EDward Gaming,7,19,EDward Gaming,10,2,8
258,Evil Geniuses,LOUD,Evil Geniuses,LOUD,Fracture,13,7,9,4,0,4,3,0,1,LOUD,Defense,0,Evil Geniuses,6,20,Evil Geniuses,9,3,6
258,LOUD,Evil Geniuses,Evil Geniuses,LOUD,Ascent,5,13,5,0,0,6,7,0,2,Evil Geniuses,Defense,0,Evil Geniuses,-8,18,LOUD,5,7,-2
259,EDward Gaming,Team Liquid,EDward Gaming,Team Liquid,Haven,9,13,6,3,0,7,6,0,1,Team Liquid,Defense,0,Team Liquid,-4,22,EDward Gaming,6,6,0
259,Team Liquid,EDward Gaming,EDward Gaming,Team Liquid,Split,8,13,2,6,0,6,7,0,2,EDward Gaming,Attack,0,EDward Gaming,-5,21,Team Liquid,6,6,0
259,Team Liquid,EDward Gaming,EDward Gaming,Team Liquid,Lotus,13,11,8,5,0,7,4,0,3,EDward Gaming,Attack,0,Team Liquid,2,24,,5,7,-2
260,FNATIC,NRG Esports,FNATIC,NRG Esports,Fracture,13,9,7,6,0,6,3,0,1,NRG Esports,Attack,0,FNATIC,4,22,FNATIC,6,6,0
260,NRG Esports,FNATIC,FNATIC,NRG Esports,Bind,4,13,2,2,0,10,3,0,2,FNATIC,Attack,0,FNATIC,-9,17,NRG Esports,2,10,-8
261,DRX,Paper Rex,DRX,Paper Rex,Split,10,13,7,3,0,9,4,0,1,Paper Rex,Attack,0,Paper Rex,-3,23,DRX,3,9,-6
261,Paper Rex,DRX,DRX,Paper Rex,Bind,13,10,5,8,0,4,6,0,2,DRX,Attack,0,Paper Rex,3,23,Paper Rex,8,4,4
262,LOUD,EDward Gaming,LOUD,EDward Gaming,Lotus,6,13,2,4,0,8,5,0,1,EDward Gaming,Attack,0,EDward Gaming,-7,19,LOUD,4,8,-4
262,EDward Gaming,LOUD,LOUD,EDward Gaming,Fracture,13,10,8,5,0,7,3,0,2,LOUD,Attack,0,EDward Gaming,3,23,EDward Gaming,5,7,-2
263,DRX,NRG Esports,DRX,NRG Esports,Pearl,11,13,3,8,0,4,9,0,1,NRG Esports,Attack,0,NRG Esports,-2,24,DRX,8,4,4
263,NRG Esports,DRX,DRX,NRG Esports,Haven,13,5,5,8,0,4,1,0,2,DRX,Attack,0,NRG Esports,8,18,NRG Esports,8,4,4
264,Evil Geniuses,Team Liquid,Evil Geniuses,Team Liquid,Fracture,13,2,11,2,0,1,1,0,1,Team Liquid,Defense,0,Evil Geniuses,11,15,Evil Geniuses,11,1,10
264,Team Liquid,Evil Geniuses,Evil Geniuses,Team Liquid,Haven,9,13,5,4,0,6,7,0,2,Evil Geniuses,Defense,0,Evil Geniuses,-4,22,Team Liquid,5,7,-2
265,FNATIC,Paper Rex,FNATIC,Paper Rex,Lotus,13,5,1,12,0,0,5,0,1,Paper Rex,Attack,0,FNATIC,8,18,FNATIC,12,0,12
265,Paper Rex,FNATIC,FNATIC,Paper Rex,Bind,7,13,4,3,0,9,4,0,2,FNATIC,Attack,0,FNATIC,-6,20,Paper Rex,3,9,-6
266,NRG Esports,Team Liquid,NRG Esports,Team Liquid,Haven,14,12,4,8,2,4,8,0,1,Team Liquid,Defense,1,NRG Esports,2,26,NRG Esports,4,8,-4
266,Team Liquid,NRG Esports,NRG Esports,Team Liquid,Ascent,13,8,7,6,0,3,5,0,2,NRG Esports,Defense,0,Team Liquid,5,21,Team Liquid,7,5,2
266,Team Liquid,NRG Esports,NRG Esports,Team Liquid,Split,5,13,1,4,0,8,5,0,3,NRG Esports,Attack,0,NRG Esports,-8,18,,4,8,-4
267,EDward Gaming,Paper Rex,EDward Gaming,Paper Rex,Fracture,12,14,4,8,0,4,8,2,1,Paper Rex,Attack,1,Paper Rex,-2,26,EDward Gaming,8,4,4
267,Paper Rex,EDward Gaming,EDward Gaming,Paper Rex,Split,9,13,3,6,0,6,7,0,2,EDward Gaming,Attack,0,EDward Gaming,-4,22,Paper Rex,6,6,0
267,Paper Rex,EDward Gaming,EDward Gaming,Paper Rex,Lotus,13,8,5,8,0,4,4,0,3,EDward Gaming,Attack,0,Paper Rex,5,21,,8,4,4
268,FNATIC,Evil Geniuses,FNATIC,Evil Geniuses,Lotus,13,3,10,3,0,1,2,0,1,Evil Geniuses,Defense,0,FNATIC,10,16,FNATIC,10,2,8
268,Evil Geniuses,FNATIC,FNATIC,Evil Geniuses,Fracture,13,9,4,9,0,3,6,0,2,FNATIC,Attack,0,Evil Geniuses,4,22,Evil Geniuses,9,3,6
268,Evil Geniuses,FNATIC,FNATIC,Evil Geniuses,Split,11,13,6,5,0,7,6,0,3,FNATIC,Defense,0,FNATIC,-2,24,,6,6,0
269,NRG Esports,Paper Rex,NRG Esports,Paper Rex,Pearl,13,15,5,7,1,5,7,3,1,Paper Rex,Attack,1,Paper Rex,-2,28,NRG Esports,7,5,2
269,Paper Rex,NRG Esports,NRG Esports,Paper Rex,Lotus,6,13,4,2,0,10,3,0,2,NRG Esports,Attack,0,NRG Esports,-7,19,Paper Rex,2,10,-8
269,Paper Rex,NRG Esports,NRG Esports,Paper Rex,Bind,13,11,8,5,0,7,4,0,3,NRG Esports,Attack,0,Paper Rex,2,24,,5,7,-2
270,Evil Geniuses,Paper Rex,Evil Geniuses,Paper Rex,Fracture,13,7,4,9,0,3,4,0,1,Paper Rex,Attack,0,Evil Geniuses,6,20,Evil Geniuses,9,3,6
270,Paper Rex,Evil Geniuses,Evil Geniuses,Paper Rex,Lotus,14,12,7,5,2,7,5,0,2,Evil Geniuses,Defense,1,Paper Rex,2,26,Paper Rex,7,5,2
270,Evil Geniuses,Paper Rex,Evil Geniuses,Paper Rex,Split,10,13,2,8,0,4,9,0,3,Paper Rex,Attack,0,Paper Rex,-3,23,Evil Geniuses,8,4,4
270,Paper Rex,Evil Geniuses,Evil Geniuses,Paper Rex,Pearl,6,13,5,1,0,6,7,0,4,Evil Geniuses,Defense,0,Evil Geniuses,-7,19,Paper Rex,5,7,-2
270,Evil Geniuses,Paper Rex,Evil Geniuses,Paper Rex,Ascent,13,8,8,5,0,4,4,0,5,Paper Rex,Defense,0,Evil Geniuses,5,21,,8,4,4
271,FNATIC,Evil Geniuses,FNATIC,Evil Geniuses,Lotus,13,8,6,7,0,2,6,0,1,Evil Geniuses,Defense,0,FNATIC,5,21,FNATIC,6,6,0
271,Evil Geniuses,FNATIC,FNATIC,Evil Geniuses,Split,11,13,4,7,0,5,8,0,2,FNATIC,Defense,0,FNATIC,-2,24,Evil Geniuses,4,8,-4
271,FNATIC,Evil Geniuses,FNATIC,Evil Geniuses,Bind,14,12,8,4,2,8,4,0,3,Evil Geniuses,Attack,1,FNATIC,2,26,FNATIC,4,8,-4
272,KRÜ Esports,MIBR,KRÜ Esports,MIBR,Bind,13,7,4,9,0,3,4,0,1,MIBR,Attack,0,KRÜ Esports,6,20,KRÜ Esports,9,3,6
272,MIBR,KRÜ Esports,KRÜ Esports,MIBR,Lotus,8,13,5,3,0,9,4,0,2,KRÜ Esports,Attack,0,KRÜ Esports,-5,21,MIBR,3,9,-6
273,KRÜ Esports,FURIA,KRÜ Esports,FURIA,Split,12,14,7,5,0,7,5,2,1,FURIA,Attack,1,FURIA,-2,26,KRÜ Esports,5,7,-2
273,FURIA,KRÜ Esports,KRÜ Esports,FURIA,Ascent,4,13,1,3,0,9,4,0,2,KRÜ Esports,Attack,0,KRÜ Esports,-9,17,FURIA,3,9,-6
273,FURIA,KRÜ Esports,KRÜ Esports,FURIA,Bind,11,13,4,7,0,5,8,0,3,KRÜ Esports,Attack,0,KRÜ Esports,-2,24,,7,5,2
274,100 Thieves,Sentinels,100 Thieves,Sentinels,Pearl,14,12,3,9,2,3,9,0,1,Sentinels,Defense,1,100 Thieves,2,26,100 Thieves,3,9,-6
274,Sentinels,100 Thieves,100 Thieves,Sentinels,Split,13,7,5,8,0,0,7,0,2,100 Thieves,Defense,0,Sentinels,6,20,Sentinels,5,7,-2
274,Sentinels,100 Thieves,100 Thieves,Sentinels,Bind,13,7,10,3,0,5,2,0,3,100 Thieves,Defense,0,Sentinels,6,20,,10,2,8
275,Sentinels,Cloud9,Sentinels,Cloud9,Pearl,8,13,4,4,0,8,5,0,1,Cloud9,Attack,0,Cloud9,-5,21,Sentinels,4,8,-4
275,Cloud9,Sentinels,Sentinels,Cloud9,Fracture,5,13,3,2,0,4,9,0,2,Sentinels,Defense,0,Sentinels,-8,18,Cloud9,3,9,-6
275,Cloud9,Sentinels,Sentinels,Cloud9,Split,13,8,8,5,0,4,4,0,3,Sentinels,Defense,0,Cloud9,5,21,,8,4,4
276,KRÜ Esports,LEVIATÁN,KRÜ Esports,LEVIATÁN,Split,13,5,9,4,0,2,3,0,1,LEVIATÁN,Defense,0,KRÜ Esports,8,18,KRÜ Esports,9,3,6
276,LEVIATÁN,KRÜ Esports,KRÜ Esports,LEVIATÁN,Lotus,7,13,5,2,0,6,7,0,2,KRÜ Esports,Defense,0,KRÜ Esports,-6,20,LEVIATÁN,5,7,-2
277,KRÜ Esports,Cloud9,KRÜ Esports,Cloud9,Ascent,4,13,4,0,0,5,8,0,1,Cloud9,Defense,0,Cloud9,-9,17,KRÜ Esports,4,8,-4
277,Cloud9,KRÜ Esports,KRÜ Esports,Cloud9,Pearl,4,13,4,0,0,12,1,0,2,KRÜ Esports,Attack,0,KRÜ Esports,-9,17,Cloud9,0,12,-12
277,Cloud9,KRÜ Esports,KRÜ Esports,Cloud9,Haven,6,13,2,4,0,8,5,0,3,KRÜ Esports,Attack,0,KRÜ Esports,-7,19,,4,8,-4
278,LEVIATÁN,Sentinels,LEVIATÁN,Sentinels,Fracture,13,8,6,7,0,2,6,0,1,Sentinels,Defense,0,LEVIATÁN,5,21,LEVIATÁN,6,6,0
278,Sentinels,LEVIATÁN,LEVIATÁN,Sentinels,Split,4,13,4,0,0,5,8,0,2,LEVIATÁN,Defense,0,LEVIATÁN,-9,17,Sentinels,4,8,-4
279,Cloud9,LEVIATÁN,Cloud9,LEVIATÁN,Lotus,13,7,8,5,0,3,4,0,1,LEVIATÁN,Defense,0,Cloud9,6,20,Cloud9,8,4,4
279,LEVIATÁN,Cloud9,Cloud9,LEVIATÁN,Pearl,9,13,3,6,0,6,7,0,2,Cloud9,Attack,0,Cloud9,-4,22,LEVIATÁN,6,6,0
279,Cloud9,LEVIATÁN,Cloud9,LEVIATÁN,Split,11,13,6,5,0,7,6,0,3,LEVIATÁN,Defense,0,LEVIATÁN,-2,24,Cloud9,6,6,0
279,LEVIATÁN,Cloud9,Cloud9,LEVIATÁN,Haven,13,10,10,3,0,9,1,0,4,Cloud9,Attack,0,LEVIATÁN,3,23,LEVIATÁN,3,9,-6
279,Cloud9,LEVIATÁN,Cloud9,LEVIATÁN,Bind,7,13,2,5,0,7,6,0,5,LEVIATÁN,Attack,0,LEVIATÁN,-6,20,,5,7,-2
280,KRÜ Esports,LEVIATÁN,KRÜ Esports,LEVIATÁN,Split,13,5,9,4,0,2,3,0,1,LEVIATÁN,Defense,0,KRÜ Esports,8,18,KRÜ Esports,9,3,6
280,LEVIATÁN,KRÜ Esports,KRÜ Esports,LEVIATÁN,Pearl,13,8,5,8,0,1,7,0,2,KRÜ Esports,Defense,0,LEVIATÁN,5,21,LEVIATÁN,5,7,-2
280,KRÜ Esports,LEVIATÁN,KRÜ Esports,LEVIATÁN,Ascent,13,6,7,6,0,1,5,0,3,LEVIATÁN,Defense,0,KRÜ Esports,7,19,KRÜ Esports,7,5,2
280,LEVIATÁN,KRÜ Esports,KRÜ Esports,LEVIATÁN,Lotus,10,13,6,4,0,7,6,0,4,KRÜ Esports,Defense,0,KRÜ Esports,-3,23,LEVIATÁN,6,6,0
281,DetonatioN FocusMe,TALON,DetonatioN FocusMe,TALON,Fracture,7,13,2,5,0,7,6,0,1,TALON,Attack,0,TALON,-6,20,DetonatioN FocusMe,5,7,-2
281,TALON,DetonatioN FocusMe,DetonatioN FocusMe,TALON,Ascent,13,8,7,6,0,3,5,0,2,DetonatioN FocusMe,Defense,0,TALON,5,21,TALON,7,5,2
282,Global Esports,Rex Regum Qeon,Global Esports,Rex Regum Qeon,Split,10,13,5,5,0,7,6,0,1,Rex Regum Qeon,Attack,0,Rex Regum Qeon,-3,23,Global Esports,5,7,-2
282,Rex Regum Qeon,Global Esports,Global Esports,Rex Regum Qeon,Ascent,13,10,6,7,0,4,6,0,2,Global Esports,Defense,0,Rex Regum Qeon,3,23,Rex Regum Qeon,6,6,0
283,TALON,Gen.G,TALON,Gen.G,Pearl,13,11,3,10,0,2,9,0,1,Gen.G,Defense,0,TALON,2,24,TALON,3,9,-6
283,Gen.G,TALON,TALON,Gen.G,Split,13,10,6,7,0,5,5,0,2,TALON,Attack,0,Gen.G,3,23,Gen.G,7,5,2
283,Gen.G,TALON,TALON,Gen.G,Haven,15,13,8,4,3,8,4,1,3,TALON,Attack,1,Gen.G,2,28,,4,8,-4
284,Rex Regum Qeon,ZETA DIVISION,Rex Regum Qeon,ZETA DIVISION,Haven,13,2,3,10,0,2,0,0,1,ZETA DIVISION,Attack,0,Rex Regum Qeon,11,15,Rex Regum Qeon,10,2,8
284,ZETA DIVISION,Rex Regum Qeon,Rex Regum Qeon,ZETA DIVISION,Split,13,8,6,7,0,5,3,0,2,Rex Regum Qeon,Attack,0,ZETA DIVISION,5,21,ZETA DIVISION,7,5,2
284,ZETA DIVISION,Rex Regum Qeon,Rex Regum Qeon,ZETA DIVISION,Ascent,21,19,4,8,9,4,8,7,3,Rex Regum Qeon,Attack,1,ZETA DIVISION,2,40,,8,4,4
285,Team Secret,Gen.G,Team Secret,Gen.G,Haven,13,6,4,9,0,3,3,0,1,Gen.G,Attack,0,Team Secret,7,19,Team Secret,9,3,6
285,Gen.G,Team Secret,Team Secret,Gen.G,Ascent,8,13,4,4,0,5,8,0,2,Team Secret,Defense,0,Team Secret,-5,21,Gen.G,4,8,-4
286,Team Secret,ZETA DIVISION,Team Secret,ZETA DIVISION,Lotus,9,13,6,3,0,9,4,0,1,ZETA DIVISION,Attack,0,ZETA DIVISION,-4,22,Team Secret,3,9,-6
286,ZETA DIVISION,Team Secret,Team Secret,ZETA DIVISION,Fracture,13,7,7,6,0,6,1,0,2,Team Secret,Attack,0,ZETA DIVISION,6,20,ZETA DIVISION,6,6,0
287,Rex Regum Qeon,Gen.G,Rex Regum Qeon,Gen.G,Haven,6,13,4,2,0,5,8,0,1,Gen.G,Defense,0,Gen.G,-7,19,Rex Regum Qeon,4,8,-4
287,Gen.G,Rex Regum Qeon,Rex Regum Qeon,Gen.G,Lotus,2,13,0,2,0,10,3,0,2,Rex Regum Qeon,Attack,0,Rex Regum Qeon,-11,15,Gen.G,2,10,-8
287,Gen.G,Rex Regum Qeon,Rex Regum Qeon,Gen.G,Ascent,13,7,9,4,0,4,3,0,3,Rex Regum Qeon,Defense,0,Gen.G,6,20,,9,3,6
288,Team Secret,Gen.G,Team Secret,Gen.G,Haven,10,13,3,7,0,4,9,0,1,Gen.G,Defense,0,Gen.G,-3,23,Team Secret,3,9,-6
288,Gen.G,Team Secret,Team Secret,Gen.G,Pearl,11,13,4,7,0,5,8,0,2,Team Secret,Attack,0,Team Secret,-2,24,Gen.G,7,5,2
288,Team Secret,Gen.G,Team Secret,Gen.G,Ascent,13,2,10,3,0,0,2,0,3,Gen.G,Defense,0,Team Secret,11,15,Team Secret,10,2,8
288,Gen.G,Team Secret,Team Secret,Gen.G,Lotus,6,13,4,2,0,10,3,0,4,Team Secret,Attack,0,Team Secret,-7,19,Gen.G,2,10,-8
289,ZETA DIVISION,Team Secret,ZETA DIVISION,Team Secret,Fracture,14,12,5,7,2,5,7,0,1,Team Secret,Attack,1,ZETA DIVISION,2,26,ZETA DIVISION,7,5,2
289,Team Secret,ZETA DIVISION,ZETA DIVISION,Team Secret,Ascent,13,9,6,7,0,3,6,0,2,ZETA DIVISION,Defense,0,Team Secret,4,22,Team Secret,6,6,0
289,ZETA DIVISION,Team Secret,ZETA DIVISION,Team Secret,Split,13,7,10,3,0,5,2,0,3,Team Secret,Defense,0,ZETA DIVISION,6,20,ZETA DIVISION,10,2,8
289,Team Secret,ZETA DIVISION,ZETA DIVISION,Team Secret,Lotus,6,13,1,5,0,7,6,0,4,ZETA DIVISION,Attack,0,ZETA DIVISION,-7,19,Team Secret,5,7,-2
290,KOI,Team Heretics,KOI,Team Heretics,Fracture,13,8,8,5,0,7,1,0,1,Team Heretics,Attack,0,KOI,5,21,KOI,5,7,-2
290,Team Heretics,KOI,KOI,Team Heretics,Pearl,13,10,4,9,0,2,8,0,2,KOI,Defense,0,Team Heretics,3,23,Team Heretics,4,8,-4
290,Team Heretics,KOI,KOI,Team Heretics,Haven,6,13,4,2,0,5,8,0,3,KOI,Defense,0,KOI,-7,19,,4,8,-4
291,BBL Esports,Karmine Corp,BBL Esports,Karmine Corp,Haven,14,12,4,8,2,4,8,0,1,Karmine Corp,Defense,1,BBL Esports,2,26,BBL Esports,4,8,-4
291,Karmine Corp,BBL Esports,BBL Esports,Karmine Corp,Lotus,13,9,6,7,0,5,4,0,2,BBL Esports,Attack,0,Karmine Corp,4,22,Karmine Corp,7,5,2
291,Karmine Corp,BBL Esports,BBL Esports,Karmine Corp,Bind,14,12,7,5,2,7,5,0,3,BBL Esports,Defense,1,Karmine Corp,2,26,,7,5,2
292,KOI,Natus Vincere,KOI,Natus Vincere,Split,13,6,6,7,0,0,6,0,1,Natus Vincere,Defense,0,KOI,7,19,KOI,6,6,0
292,Natus Vincere,KOI,KOI,Natus Vincere,Lotus,3,13,3,0,0,4,9,0,2,KOI,Defense,0,KOI,-10,16,Natus Vincere,3,9,-6
293,Karmine Corp,GIANTX,Karmine Corp,GIANTX,Pearl,11,13,3,8,0,4,9,0,1,GIANTX,Defense,0,GIANTX,-2,24,Karmine Corp,3,9,-6
293,GIANTX,Karmine Corp,Karmine Corp,GIANTX,Split,13,5,10,3,0,3,2,0,2,Karmine Corp,Defense,0,GIANTX,8,18,GIANTX,10,2,8
294,KOI,GIANTX,KOI,GIANTX,Haven,12,14,5,7,0,5,7,2,1,GIANTX,Defense,1,GIANTX,-2,26,KOI,5,7,-2
294,GIANTX,KOI,KOI,GIANTX,Pearl,13,5,7,6,0,0,5,0,2,KOI,Defense,0,GIANTX,8,18,GIANTX,7,5,2
295,Karmine Corp,Natus Vincere,Karmine Corp,Natus Vincere,Lotus,6,13,5,1,0,6,7,0,1,Natus Vincere,Defense,0,Natus Vincere,-7,19,Karmine Corp,5,7,-2
295,Natus Vincere,Karmine Corp,Karmine Corp,Natus Vincere,Ascent,7,13,5,2,0,6,7,0,2,Karmine Corp,Defense,0,Karmine Corp,-6,20,Natus Vincere,5,7,-2
295,Natus Vincere,Karmine Corp,Karmine Corp,Natus Vincere,Pearl,13,7,8,5,0,3,4,0,3,Karmine Corp,Defense,0,Natus Vincere,6,20,,8,4,4
296,KOI,Natus Vincere,KOI,Natus Vincere,Split,12,14,5,7,0,5,7,2,1,Natus Vincere,Attack,1,Natus Vincere,-2,26,KOI,7,5,2
296,Natus Vincere,KOI,KOI,Natus Vincere,Pearl,13,10,10,3,0,8,2,0,2,KOI,Defense,0,Natus Vincere,3,23,Natus Vincere,10,2,8
296,KOI,Natus Vincere,KOI,Natus Vincere,Fracture,9,13,7,2,0,8,5,0,3,Natus Vincere,Defense,0,Natus Vincere,-4,22,KOI,7,5,2
297,GIANTX,Natus Vincere,GIANTX,Natus Vincere,Bind,13,11,6,7,0,5,6,0,1,Natus Vincere,Defense,0,GIANTX,2,24,GIANTX,6,6,0
297,Natus Vincere,GIANTX,GIANTX,Natus Vincere,Lotus,7,13,5,2,0,6,7,0,2,GIANTX,Defense,0,GIANTX,-6,20,Natus Vincere,5,7,-2
297,GIANTX,Natus Vincere,GIANTX,Natus Vincere,Haven,13,9,7,6,0,4,5,0,3,Natus Vincere,Defense,0,GIANTX,4,22,GIANTX,7,5,2
298,Natus Vincere,Team Liquid,Natus Vincere,Team Liquid,Fracture,13,11,7,6,0,6,5,0,1,Team Liquid,Attack,0,Natus Vincere,2,24,Natus Vincere,6,6,0
298,Team Liquid,Natus Vincere,Natus Vincere,Team Liquid,Bind,15,17,7,5,3,7,5,5,2,Natus Vincere,Defense,1,Natus Vincere,-2,32,Team Liquid,7,5,2
299,LOUD,DRX,LOUD,DRX,Lotus,15,13,7,5,3,7,5,1,1,DRX,Attack,1,LOUD,2,28,LOUD,5,7,-2
299,DRX,LOUD,LOUD,DRX,Split,13,6,5,8,0,4,2,0,2,LOUD,Attack,0,DRX,7,19,DRX,8,4,4
299,DRX,LOUD,LOUD,DRX,Ascent,13,8,5,8,0,4,4,0,3,LOUD,Attack,0,DRX,5,21,,8,4,4
300,T1,FUT Esports,T1,FUT Esports,Pearl,4,13,3,1,0,4,9,0,1,FUT Esports,Defense,0,FUT Esports,-9,17,T1,3,9,-6
300,FUT Esports,T1,T1,FUT Esports,Haven,13,7,6,7,0,5,2,0,2,T1,Attack,0,FUT Esports,6,20,FUT Esports,7,5,2
301,Evil Geniuses,FunPlus Phoenix,Evil Geniuses,FunPlus Phoenix,Ascent,13,8,7,6,0,6,2,0,1,FunPlus Phoenix,Attack,0,Evil Geniuses,5,21,Evil Geniuses,6,6,0
301,FunPlus Phoenix,Evil Geniuses,Evil Geniuses,FunPlus Phoenix,Pearl,8,13,3,5,0,4,9,0,2,Evil Geniuses,Defense,0,Evil Geniuses,-5,21,FunPlus Phoenix,3,9,-6
302,Natus Vincere,DRX,Natus Vincere,DRX,Bind,13,15,4,8,1,4,8,3,1,DRX,Attack,1,DRX,-2,28,Natus Vincere,8,4,4
302,DRX,Natus Vincere,Natus Vincere,DRX,Split,9,13,6,3,0,7,6,0,2,Natus Vincere,Defense,0,Natus Vincere,-4,22,DRX,6,6,0
302,DRX,Natus Vincere,Natus Vincere,DRX,Lotus,14,12,6,6,2,6,6,0,3,Natus Vincere,Defense,1,DRX,2,26,,6,6,0
303,Bilibili Gaming,NRG Esports,Bilibili Gaming,NRG Esports,Lotus,14,12,7,5,2,7,5,0,1,NRG Esports,Attack,1,Bilibili Gaming,2,26,Bilibili Gaming,5,7,-2
303,NRG Esports,Bilibili Gaming,Bilibili Gaming,NRG Esports,Split,8,13,4,4,0,5,8,0,2,Bilibili Gaming,Defense,0,Bilibili Gaming,-5,21,NRG Esports,4,8,-4
304,ZETA DIVISION,FNATIC,ZETA DIVISION,FNATIC,Fracture,5,13,1,4,0,8,5,0,1,FNATIC,Attack,0,FNATIC,-8,18,ZETA DIVISION,4,8,-4
304,FNATIC,ZETA DIVISION,ZETA DIVISION,FNATIC,Haven,13,6,7,6,0,1,5,0,2,ZETA DIVISION,Defense,0,FNATIC,7,19,FNATIC,7,5,2
305,Evil Geniuses,FUT Esports,Evil Geniuses,FUT Esports,Pearl,15,13,3,9,3,3,9,1,1,FUT Esports,Attack,1,Evil Geniuses,2,28,Evil Geniuses,9,3,6
305,FUT Esports,Evil Geniuses,Evil Geniuses,FUT Esports,Bind,9,13,6,3,0,7,6,0,2,Evil Geniuses,Defense,0,Evil Geniuses,-4,22,FUT Esports,6,6,0
306,KRÜ Esports,Paper Rex,KRÜ Esports,Paper Rex,Split,7,13,3,4,0,8,5,0,1,Paper Rex,Attack,0,Paper Rex,-6,20,KRÜ Esports,4,8,-4
306,Paper Rex,KRÜ Esports,KRÜ Esports,Paper Rex,Pearl,13,8,8,5,0,4,4,0,2,KRÜ Esports,Defense,0,Paper Rex,5,21,Paper Rex,8,4,4
307,GIANTX,EDward Gaming,GIANTX,EDward Gaming,Split,15,13,9,3,3,9,3,1,1,EDward Gaming,Defense,1,GIANTX,2,28,GIANTX,9,3,6
307,EDward Gaming,GIANTX,GIANTX,EDward Gaming,Bind,13,11,6,7,0,5,6,0,2,GIANTX,Defense,0,EDward Gaming,2,24,EDward Gaming,6,6,0
307,EDward Gaming,GIANTX,GIANTX,EDward Gaming,Ascent,13,8,7,6,0,3,5,0,3,GIANTX,Defense,0,EDward Gaming,5,21,,7,5,2
308,Bilibili Gaming,FNATIC,Bilibili Gaming,FNATIC,Haven,2,13,0,2,0,10,3,0,1,FNATIC,Attack,0,FNATIC,-11,15,Bilibili Gaming,2,10,-8
308,FNATIC,Bilibili Gaming,Bilibili Gaming,FNATIC,Lotus,13,8,9,4,0,5,3,0,2,Bilibili Gaming,Defense,0,FNATIC,5,21,FNATIC,9,3,6
309,LOUD,Team Liquid,LOUD,Team Liquid,Haven,13,2,3,10,0,2,0,0,1,Team Liquid,Attack,0,LOUD,11,15,LOUD,10,2,8
309,Team Liquid,LOUD,LOUD,Team Liquid,Split,8,13,2,6,0,6,7,0,2,LOUD,Attack,0,LOUD,-5,21,Team Liquid,6,6,0
310,FunPlus Phoenix,T1,FunPlus Phoenix,T1,Lotus,10,13,7,3,0,8,5,0,1,T1,Defense,0,T1,-3,23,FunPlus Phoenix,7,5,2
310,T1,FunPlus Phoenix,FunPlus Phoenix,T1,Bind,13,7,9,4,0,4,3,0,2,FunPlus Phoenix,Defense,0,T1,6,20,T1,9,3,6
311,EDward Gaming,Paper Rex,EDward Gaming,Paper Rex,Fracture,7,13,3,4,0,8,5,0,1,Paper Rex,Attack,0,Paper Rex,-6,20,EDward Gaming,4,8,-4
311,Paper Rex,EDward Gaming,EDward Gaming,Paper Rex,Pearl,16,14,7,5,4,7,5,2,2,EDward Gaming,Attack,1,Paper Rex,2,30,Paper Rex,5,7,-2
312,KRÜ Esports,GIANTX,KRÜ Esports,GIANTX,Lotus,10,13,7,3,0,8,5,0,1,GIANTX,Defense,0,GIANTX,-3,23,KRÜ Esports,7,5,2
312,GIANTX,KRÜ Esports,KRÜ Esports,GIANTX,Pearl,14,12,5,7,2,5,7,0,2,KRÜ Esports,Attack,1,GIANTX,2,26,GIANTX,7,5,2
313,ZETA DIVISION,NRG Esports,ZETA DIVISION,NRG Esports,Bind,13,15,5,7,1,5,7,3,1,NRG Esports,Attack,1,NRG Esports,-2,28,ZETA DIVISION,7,5,2
313,NRG Esports,ZETA DIVISION,ZETA DIVISION,NRG Esports,Haven,13,1,11,2,0,0,1,0,2,ZETA DIVISION,Defense,0,NRG Esports,12,14,NRG Esports,11,1,10
314,Natus Vincere,LOUD,Natus Vincere,LOUD,Pearl,13,11,5,8,0,4,7,0,1,LOUD,Attack,0,Natus Vincere,2,24,Natus Vincere,8,4,4
314,LOUD,Natus Vincere,Natus Vincere,LOUD,Ascent,13,11,6,7,0,5,6,0,2,Natus Vincere,Defense,0,LOUD,2,24,LOUD,6,6,0
314,LOUD,Natus Vincere,Natus Vincere,LOUD,Bind,13,11,7,6,0,6,5,0,3,Natus Vincere,Defense,0,LOUD,2,24,,7,5,2
315,T1,FUT Esports,T1,FUT Esports,Bind,10,13,2,8,0,3,10,0,1,FUT Esports,Defense,0,FUT Esports,-3,23,T1,2,10,-8
315,FUT Esports,T1,T1,FUT Esports,Pearl,14,12,7,5,2,7,5,0,2,T1,Defense,1,FUT Esports,2,26,FUT Esports,7,5,2
316,GIANTX,EDward Gaming,GIANTX,EDward Gaming,Split,6,13,3,3,0,9,4,0,1,EDward Gaming,Attack,0,EDward Gaming,-7,19,GIANTX,3,9,-6
316,EDward Gaming,GIANTX,GIANTX,EDward Gaming,Fracture,13,7,5,8,0,4,3,0,2,GIANTX,Attack,0,EDward Gaming,6,20,EDward Gaming,8,4,4
317,NRG Esports,Bilibili Gaming,NRG Esports,Bilibili Gaming,Bind,10,13,7,3,0,8,5,0,1,Bilibili Gaming,Defense,0,Bilibili Gaming,-3,23,NRG Esports,7,5,2
317,Bilibili Gaming,NRG Esports,NRG Esports,Bilibili Gaming,Ascent,13,5,8,5,0,1,4,0,2,NRG Esports,Defense,0,Bilibili Gaming,8,18,Bilibili Gaming,8,4,4
318,LOUD,FNATIC,LOUD,FNATIC,Ascent,13,11,6,7,0,5,6,0,1,FNATIC,Defense,0,LOUD,2,24,LOUD,6,6,0
318,FNATIC,LOUD,LOUD,FNATIC,Lotus,6,13,2,4,0,8,5,0,2,LOUD,Attack,0,LOUD,-7,19,FNATIC,4,8,-4
319,FUT Esports,Paper Rex,FUT Esports,Paper Rex,Ascent,10,13,2,8,0,4,9,0,1,Paper Rex,Attack,0,Paper Rex,-3,23,FUT Esports,8,4,4
319,Paper Rex,FUT Esports,FUT Esports,Paper Rex,Pearl,13,4,11,2,0,3,1,0,2,FUT Esports,Defense,0,Paper Rex,9,17,Paper Rex,11,1,10
320,Bilibili Gaming,DRX,Bilibili Gaming,DRX,Lotus,10,13,0,10,0,2,11,0,1,DRX,Attack,0,DRX,-3,23,Bilibili Gaming,10,2,8
320,DRX,Bilibili Gaming,Bilibili Gaming,DRX,Haven,13,9,7,6,0,4,5,0,2,Bilibili Gaming,Defense,0,DRX,4,22,DRX,7,5,2
321,EDward Gaming,Evil Geniuses,EDward Gaming,Evil Geniuses,Split,14,12,8,4,2,8,4,0,1,Evil Geniuses,Defense,1,EDward Gaming,2,26,EDward Gaming,8,4,4
321,Evil Geniuses,EDward Gaming,EDward Gaming,Evil Geniuses,Ascent,13,5,5,8,0,4,1,0,2,EDward Gaming,Attack,0,Evil Geniuses,8,18,Evil Geniuses,8,4,4
321,Evil Geniuses,EDward Gaming,EDward Gaming,Evil Geniuses,Pearl,13,5,5,8,0,4,1,0,3,EDward Gaming,Attack,0,Evil Geniuses,8,18,,8,4,4
322,FNATIC,FUT Esports,FNATIC,FUT Esports,Split,13,5,10,3,0,3,2,0,1,FUT Esports,Defense,0,FNATIC,8,18,FNATIC,10,2,8
322,FUT Esports,FNATIC,FNATIC,FUT Esports,Haven,9,13,2,7,0,5,8,0,2,FNATIC,Attack,0,FNATIC,-4,22,FUT Esports,7,5,2
323,Bilibili Gaming,EDward Gaming,Bilibili Gaming,EDward Gaming,Bind,4,13,2,2,0,10,3,0,1,EDward Gaming,Attack,0,EDward Gaming,-9,17,Bilibili Gaming,2,10,-8
323,EDward Gaming,Bilibili Gaming,Bilibili Gaming,EDward Gaming,Split,13,15,4,8,1,4,8,3,2,Bilibili Gaming,Defense,1,Bilibili Gaming,-2,28,EDward Gaming,4,8,-4
323,EDward Gaming,Bilibili Gaming,Bilibili Gaming,EDward Gaming,Haven,13,10,7,6,0,6,4,0,3,Bilibili Gaming,Attack,0,EDward Gaming,3,23,,6,6,0
324,LOUD,Paper Rex,LOUD,Paper Rex,Lotus,13,15,5,7,1,5,7,3,1,Paper Rex,Attack,1,Paper Rex,-2,28,LOUD,7,5,2
324,Paper Rex,LOUD,LOUD,Paper Rex,Split,2,13,0,2,0,10,3,0,2,LOUD,Attack,0,LOUD,-11,15,Paper Rex,2,10,-8
324,Paper Rex,LOUD,LOUD,Paper Rex,Pearl,13,10,7,6,0,5,5,0,3,LOUD,Defense,0,Paper Rex,3,23,,7,5,2
325,Evil Geniuses,DRX,Evil Geniuses,DRX,Fracture,13,9,5,8,0,4,5,0,1,DRX,Attack,0,Evil Geniuses,4,22,Evil Geniuses,8,4,4
325,DRX,Evil Geniuses,Evil Geniuses,DRX,Lotus,4,13,2,2,0,10,3,0,2,Evil Geniuses,Attack,0,Evil Geniuses,-9,17,DRX,2,10,-8
326,EDward Gaming,LOUD,EDward Gaming,LOUD,Bind,13,11,6,7,0,5,6,0,1,LOUD,Defense,0,EDward Gaming,2,24,EDward Gaming,6,6,0
326,LOUD,EDward Gaming,EDward Gaming,LOUD,Ascent,13,5,5,8,0,4,1,0,2,EDward Gaming,Attack,0,LOUD,8,18,LOUD,8,4,4
326,LOUD,EDward Gaming,EDward Gaming,LOUD,Haven,13,11,7,6,0,6,5,0,3,EDward Gaming,Attack,0,LOUD,2,24,,6,6,0
327,FNATIC,DRX,FNATIC,DRX,Bind,1,13,1,0,0,2,11,0,1,DRX,Defense,0,DRX,-12,14,FNATIC,1,11,-10
327,DRX,FNATIC,FNATIC,DRX,Haven,9,13,3,6,0,6,7,0,2,FNATIC,Attack,0,FNATIC,-4,22,DRX,6,6,0
327,DRX,FNATIC,FNATIC,DRX,Split,6,13,1,5,0,7,6,0,3,FNATIC,Attack,0,FNATIC,-7,19,,5,7,-2
328,Evil Geniuses,Paper Rex,Evil Geniuses,Paper Rex,Ascent,13,10,8,5,0,7,3,0,1,Paper Rex,Attack,0,Evil Geniuses,3,23,Evil Geniuses,5,7,-2
328,Paper Rex,Evil Geniuses,Evil Geniuses,Paper Rex,Bind,13,9,5,8,0,2,7,0,2,Evil Geniuses,Defense,0,Paper Rex,4,22,Paper Rex,5,7,-2
328,Paper Rex,Evil Geniuses,Evil Geniuses,Paper Rex,Pearl,15,13,6,6,3,6,6,1,3,Evil Geniuses,Defense,1,Paper Rex,2,28,,6,6,0
329,FNATIC,LOUD,FNATIC,LOUD,Split,4,13,0,4,0,8,5,0,1,LOUD,Attack,0,LOUD,-9,17,FNATIC,4,8,-4
329,LOUD,FNATIC,FNATIC,LOUD,Ascent,9,13,7,2,0,8,5,0,2,FNATIC,Defense,0,FNATIC,-4,22,LOUD,7,5,2
329,LOUD,FNATIC,FNATIC,LOUD,Haven,13,7,5,8,0,4,3,0,3,FNATIC,Attack,0,LOUD,6,20,,8,4,4
330,Evil Geniuses,LOUD,Evil Geniuses,LOUD,Ascent,14,12,7,5,2,7,5,0,1,LOUD,Defense,1,Evil Geniuses,2,26,Evil Geniuses,7,5,2
330,LOUD,Evil Geniuses,Evil Geniuses,LOUD,Lotus,4,13,2,2,0,10,3,0,2,Evil Geniuses,Attack,0,Evil Geniuses,-9,17,LOUD,2,10,-8
330,Evil Geniuses,LOUD,Evil Geniuses,LOUD,Pearl,8,13,5,3,0,9,4,0,3,LOUD,Attack,0,LOUD,-5,21,Evil Geniuses,3,9,-6
330,LOUD,Evil Geniuses,Evil Geniuses,LOUD,Split,13,7,9,4,0,4,3,0,4,Evil Geniuses,Defense,0,LOUD,6,20,LOUD,9,3,6
330,Evil Geniuses,LOUD,Evil Geniuses,LOUD,Bind,13,8,7,6,0,3,5,0,5,LOUD,Defense,0,Evil Geniuses,5,21,,7,5,2
331,Paper Rex,Evil Geniuses,Paper Rex,Evil Geniuses,Split,10,13,8,2,0,9,4,0,1,Evil Geniuses,Defense,0,Evil Geniuses,-3,23,Paper Rex,8,4,4
331,Evil Geniuses,Paper Rex,Paper Rex,Evil Geniuses,Ascent,11,13,6,5,0,7,6,0,2,Paper Rex,Attack,0,Paper Rex,-2,24,Evil Geniuses,5,7,-2
331,Paper Rex,Evil Geniuses,Paper Rex,Evil Geniuses,Bind,5,13,3,2,0,4,9,0,3,Evil Geniuses,Defense,0,Evil Geniuses,-8,18,Paper Rex,3,9,-6
331,Evil Geniuses,Paper Rex,Paper Rex,Evil Geniuses,Lotus,13,10,8,5,0,7,3,0,4,Paper Rex,Attack,0,Evil Geniuses,3,23,Evil Geniuses,5,7,-2
332,FURIA,NRG Esports,FURIA,NRG Esports,Breeze,10,13,4,6,0,5,8,0,1,NRG Esports,Defense,0,NRG Esports,-3,23,FURIA,4,8,-4
332,NRG Esports,FURIA,FURIA,NRG Esports,Ascent,13,8,6,7,0,2,6,0,2,FURIA,Defense,0,NRG Esports,5,21,NRG Esports,6,6,0
333,Cloud9,MIBR,Cloud9,MIBR,Bind,13,11,8,5,0,7,4,0,1,MIBR,Attack,0,Cloud9,2,24,Cloud9,5,7,-2
333,MIBR,Cloud9,Cloud9,MIBR,Split,13,8,6,7,0,2,6,0,2,Cloud9,Defense,0,MIBR,5,21,MIBR,6,6,0
333,MIBR,Cloud9,Cloud9,MIBR,Lotus,10,13,3,7,0,5,8,0,3,Cloud9,Attack,0,Cloud9,-3,23,,7,5,2
334,Sentinels,LOUD,Sentinels,LOUD,Split,11,13,3,8,0,4,9,0,1,LOUD,Attack,0,LOUD,-2,24,Sentinels,8,4,4
334,LOUD,Sentinels,Sentinels,LOUD,Ascent,13,9,5,8,0,2,7,0,2,Sentinels,Defense,0,LOUD,4,22,LOUD,5,7,-2
335,100 Thieves,LEVIATÁN,100 Thieves,LEVIATÁN,Bind,9,13,4,5,0,7,6,0,1,LEVIATÁN,Attack,0,LEVIATÁN,-4,22,100 Thieves,5,7,-2
335,LEVIATÁN,100 Thieves,100 Thieves,LEVIATÁN,Split,3,13,3,0,0,4,9,0,2,100 Thieves,Defense,0,100 Thieves,-10,16,LEVIATÁN,3,9,-6
335,LEVIATÁN,100 Thieves,100 Thieves,LEVIATÁN,Icebox,13,11,6,7,0,5,6,0,3,100 Thieves,Attack,0,LEVIATÁN,2,24,,7,5,2
336,G2 Esports,KRÜ Esports,G2 Esports,KRÜ Esports,Icebox,9,13,6,3,0,7,6,0,1,KRÜ Esports,Defense,0,KRÜ Esports,-4,22,G2 Esports,6,6,0
336,KRÜ Esports,G2 Esports,G2 Esports,KRÜ Esports,Sunset,9,13,6,3,0,7,6,0,2,G2 Esports,Defense,0,G2 Esports,-4,22,KRÜ Esports,6,6,0
336,KRÜ Esports,G2 Esports,G2 Esports,KRÜ Esports,Ascent,11,13,7,4,0,8,5,0,3,G2 Esports,Defense,0,G2 Esports,-2,24,,7,5,2
337,MIBR,FURIA,MIBR,FURIA,Split,13,9,8,5,0,7,2,0,1,FURIA,Attack,0,MIBR,4,22,MIBR,5,7,-2
337,FURIA,MIBR,MIBR,FURIA,Breeze,11,13,3,8,0,4,9,0,2,MIBR,Attack,0,MIBR,-2,24,FURIA,8,4,4
338,100 Thieves,Sentinels,100 Thieves,Sentinels,Lotus,5,13,2,3,0,9,4,0,1,Sentinels,Attack,0,Sentinels,-8,18,100 Thieves,3,9,-6
338,Sentinels,100 Thieves,100 Thieves,Sentinels,Bind,6,13,2,4,0,8,5,0,2,100 Thieves,Attack,0,100 Thieves,-7,19,Sentinels,4,8,-4
338,Sentinels,100 Thieves,100 Thieves,Sentinels,Split,13,8,7,6,0,3,5,0,3,100 Thieves,Defense,0,Sentinels,5,21,,7,5,2
339,Cloud9,NRG Esports,Cloud9,NRG Esports,Sunset,7,13,4,3,0,5,8,0,1,NRG Esports,Defense,0,NRG Esports,-6,20,Cloud9,4,8,-4
339,NRG Esports,Cloud9,Cloud9,NRG Esports,Ascent,14,12,5,7,2,5,7,0,2,Cloud9,Defense,1,NRG Esports,2,26,NRG Esports,5,7,-2
340,LEVIATÁN,LOUD,LEVIATÁN,LOUD,Bind,13,11,9,4,0,8,3,0,1,LOUD,Defense,0,LEVIATÁN,2,24,LEVIATÁN,9,3,6
340,LOUD,LEVIATÁN,LEVIATÁN,LOUD,Split,13,10,7,6,0,6,4,0,2,LEVIATÁN,Attack,0,LOUD,3,23,LOUD,6,6,0
340,LOUD,LEVIATÁN,LEVIATÁN,LOUD,Ascent,13,7,9,4,0,4,3,0,3,LEVIATÁN,Defense,0,LOUD,6,20,,9,3,6
341,G2 Esports,Evil Geniuses,G2 Esports,Evil Geniuses,Sunset,13,15,8,4,1,8,4,3,1,Evil Geniuses,Defense,1,Evil Geniuses,-2,28,G2 Esports,8,4,4
341,Evil Geniuses,G2 Esports,G2 Esports,Evil Geniuses,Icebox,13,11,6,7,0,5,6,0,2,G2 Esports,Attack,0,Evil Geniuses,2,24,Evil Geniuses,7,5,2
342,Cloud9,MIBR,Cloud9,MIBR,Bind,12,14,7,5,0,7,5,2,1,MIBR,Attack,1,MIBR,-2,26,Cloud9,5,7,-2
342,MIBR,Cloud9,Cloud9,MIBR,Ascent,13,9,7,6,0,4,5,0,2,Cloud9,Defense,0,MIBR,4,22,MIBR,7,5,2
343,Sentinels,LEVIATÁN,Sentinels,LEVIATÁN,Split,13,3,4,9,0,3,0,0,1,LEVIATÁN,Attack,0,Sentinels,10,16,Sentinels,9,3,6
343,LEVIATÁN,Sentinels,Sentinels,LEVIATÁN,Breeze,13,6,9,4,0,3,3,0,2,Sentinels,Defense,0,LEVIATÁN,7,19,LEVIATÁN,9,3,6
343,LEVIATÁN,Sentinels,Sentinels,LEVIATÁN,Bind,9,13,3,6,0,6,7,0,3,Sentinels,Attack,0,Sentinels,-4,22,,6,6,0
344,KRÜ Esports,G2 Esports,KRÜ Esports,G2 Esports,Split,8,13,5,3,0,6,7,0,1,G2 Esports,Defense,0,G2 Esports,-5,21,KRÜ Esports,5,7,-2
344,G2 Esports,KRÜ Esports,KRÜ Esports,G2 Esports,Sunset,13,8,8,5,0,7,1,0,2,KRÜ Esports,Attack,0,G2 Esports,5,21,G2 Esports,5,7,-2
345,Sentinels,MIBR,Sentinels,MIBR,Split,13,7,3,10,0,2,5,0,1,MIBR,Attack,0,Sentinels,6,20,Sentinels,10,2,8
345,MIBR,Sentinels,Sentinels,MIBR,Ascent,6,13,5,1,0,6,7,0,2,Sentinels,Defense,0,Sentinels,-7,19,MIBR,5,7,-2
346,G2 Esports,MIBR,G2 Esports,MIBR,Sunset,9,13,3,6,0,6,7,0,1,MIBR,Attack,0,MIBR,-4,22,G2 Esports,6,6,0
346,MIBR,G2 Esports,G2 Esports,MIBR,Split,13,15,7,5,1,7,5,3,2,G2 Esports,Defense,1,G2 Esports,-2,28,MIBR,7,5,2
346,MIBR,G2 Esports,G2 Esports,MIBR,Breeze,13,10,6,7,0,4,6,0,3,G2 Esports,Defense,0,MIBR,3,23,,6,6,0
347,Sentinels,G2 Esports,Sentinels,G2 Esports,Sunset,13,8,4,9,0,0,8,0,1,G2 Esports,Defense,0,Sentinels,5,21,Sentinels,4,8,-4
347,G2 Esports,Sentinels,Sentinels,G2 Esports,Breeze,13,9,9,4,0,6,3,0,2,Sentinels,Defense,0,G2 Esports,4,22,G2 Esports,9,3,6
347,G2 Esports,Sentinels,Sentinels,G2 Esports,Split,13,9,5,8,0,2,7,0,3,Sentinels,Defense,0,G2 Esports,4,22,,5,7,-2
348,LOUD,Evil Geniuses,LOUD,Evil Geniuses,Ascent,7,13,3,4,0,4,9,0,1,Evil Geniuses,Defense,0,Evil Geniuses,-6,20,LOUD,3,9,-6
348,Evil Geniuses,LOUD,LOUD,Evil Geniuses,Icebox,7,13,3,4,0,8,5,0,2,LOUD,Attack,0,LOUD,-6,20,Evil Geniuses,4,8,-4
348,Evil Geniuses,LOUD,LOUD,Evil Geniuses,Sunset,5,13,4,1,0,5,8,0,3,LOUD,Defense,0,LOUD,-8,18,,4,8,-4
349,Sentinels,NRG Esports,Sentinels,NRG Esports,Sunset,16,14,5,7,4,5,7,2,1,NRG Esports,Defense,1,Sentinels,2,30,Sentinels,5,7,-2
349,NRG Esports,Sentinels,Sentinels,NRG Esports,Ascent,13,8,8,5,0,4,4,0,2,Sentinels,Defense,0,NRG Esports,5,21,NRG Esports,8,4,4
349,NRG Esports,Sentinels,Sentinels,NRG Esports,Split,3,13,1,2,0,2,11,0,3,Sentinels,Defense,0,Sentinels,-10,16,,1,11,-10
350,LOUD,Sentinels,LOUD,Sentinels,Sunset,9,13,5,4,0,8,5,0,1,Sentinels,Attack,0,Sentinels,-4,22,LOUD,4,8,-4
350,Sentinels,LOUD,LOUD,Sentinels,Split,13,3,4,9,0,3,0,0,2,LOUD,Attack,0,Sentinels,10,16,Sentinels,9,3,6
350,LOUD,Sentinels,LOUD,Sentinels,Icebox,13,11,8,5,0,7,4,0,3,Sentinels,Defense,0,LOUD,2,24,LOUD,8,4,4
350,Sentinels,LOUD,LOUD,Sentinels,Bind,8,13,5,3,0,9,4,0,4,LOUD,Attack,0,LOUD,-5,21,Sentinels,3,9,-6
350,LOUD,Sentinels,LOUD,Sentinels,Lotus,4,13,2,2,0,10,3,0,5,Sentinels,Attack,0,Sentinels,-9,17,,2,10,-8
351,BLEED,T1,BLEED,T1,Breeze,16,18,6,6,4,6,6,6,1,T1,Attack,1,T1,-2,34,BLEED,6,6,0
351,T1,BLEED,BLEED,T1,Lotus,13,6,9,4,0,3,3,0,2,BLEED,Defense,0,T1,7,19,T1,9,3,6
352,Rex Regum Qeon,Gen.G,Rex Regum Qeon,Gen.G,Icebox,11,13,5,6,0,6,7,0,1,Gen.G,Attack,0,Gen.G,-2,24,Rex Regum Qeon,6,6,0
352,Gen.G,Rex Regum Qeon,Rex Regum Qeon,Gen.G,Split,11,13,2,9,0,3,10,0,2,Rex Regum Qeon,Defense,0,Rex Regum Qeon,-2,24,Gen.G,2,10,-8
352,Gen.G,Rex Regum Qeon,Rex Regum Qeon,Gen.G,Sunset,13,8,5,8,0,4,4,0,3,Rex Regum Qeon,Attack,0,Gen.G,5,21,,8,4,4
353,Global Esports,ZETA DIVISION,Global Esports,ZETA DIVISION,Bind,10,13,5,5,0,6,7,0,1,ZETA DIVISION,Defense,0,ZETA DIVISION,-3,23,Global Esports,5,7,-2
353,ZETA DIVISION,Global Esports,Global Esports,ZETA DIVISION,Icebox,13,7,7,6,0,6,1,0,2,Global Esports,Attack,0,ZETA DIVISION,6,20,ZETA DIVISION,6,6,0
354,TALON,Team Secret,TALON,Team Secret,Breeze,13,8,4,9,0,3,5,0,1,Team Secret,Attack,0,TALON,5,21,TALON,9,3,6
354,Team Secret,TALON,TALON,Team Secret,Ascent,3,13,3,0,0,4,9,0,2,TALON,Defense,0,TALON,-10,16,Team Secret,3,9,-6
355,DetonatioN FocusMe,DRX,DetonatioN FocusMe,DRX,Lotus,8,13,5,3,0,6,7,0,1,DRX,Defense,0,DRX,-5,21,DetonatioN FocusMe,5,7,-2
355,DRX,DetonatioN FocusMe,DetonatioN FocusMe,DRX,Breeze,13,8,5,8,0,4,4,0,2,DetonatioN FocusMe,Attack,0,DRX,5,21,DRX,8,4,4
356,Gen.G,Paper Rex,Gen.G,Paper Rex,Breeze,13,10,7,6,0,6,4,0,1,Paper Rex,Attack,0,Gen.G,3,23,Gen.G,6,6,0
356,Paper Rex,Gen.G,Gen.G,Paper Rex,Lotus,13,10,6,7,0,5,5,0,2,Gen.G,Attack,0,Paper Rex,3,23,Paper Rex,7,5,2
356,Paper Rex,Gen.G,Gen.G,Paper Rex,Sunset,13,7,3,10,0,2,5,0,3,Gen.G,Attack,0,Paper Rex,6,20,,10,2,8
357,Global Esports,BLEED,Global Esports,BLEED,Sunset,13,9,7,6,0,4,5,0,1,BLEED,Defense,0,Global Esports,4,22,Global Esports,7,5,2
357,BLEED,Global Esports,Global Esports,BLEED,Icebox,13,10,9,4,0,8,2,0,2,Global Esports,Attack,0,BLEED,3,23,BLEED,4,8,-4
357,BLEED,Global Esports,Global Esports,BLEED,Split,11,13,7,4,0,8,5,0,3,Global Esports,Attack,0,Global Esports,-2,24,,4,8,-4
358,ZETA DIVISION,T1,ZETA DIVISION,T1,Ascent,13,11,7,6,0,6,5,0,1,T1,Defense,0,ZETA DIVISION,2,24,ZETA DIVISION,7,5,2
358,T1,ZETA DIVISION,ZETA DIVISION,T1,Lotus,13,4,4,9,0,3,1,0,2,ZETA DIVISION,Attack,0,T1,9,17,T1,9,3,6
358,T1,ZETA DIVISION,ZETA DIVISION,T1,Sunset,13,7,5,8,0,4,3,0,3,ZETA DIVISION,Attack,0,T1,6,20,,8,4,4
359,DetonatioN FocusMe,Team Secret,DetonatioN FocusMe,Team Secret,Lotus,7,13,4,3,0,9,4,0,1,Team Secret,Attack,0,Team Secret,-6,20,DetonatioN FocusMe,3,9,-6
359,Team Secret,DetonatioN FocusMe,DetonatioN FocusMe,Team Secret,Breeze,13,11,6,7,0,5,6,0,2,DetonatioN FocusMe,Attack,0,Team Secret,2,24,Team Secret,7,5,2
360,DRX,TALON,DRX,TALON,Split,13,10,8,5,0,6,4,0,1,TALON,Defense,0,DRX,3,23,DRX,8,4,4
360,TALON,DRX,DRX,TALON,Ascent,8,13,6,2,0,7,6,0,2,DRX,Defense,0,DRX,-5,21,TALON,6,6,0
361,Rex Regum Qeon,Gen.G,Rex Regum Qeon,Gen.G,Lotus,7,13,0,7,0,5,8,0,1,Gen.G,Attack,0,Gen.G,-6,20,Rex Regum Qeon,7,5,2
361,Gen.G,Rex Regum Qeon,Rex Regum Qeon,Gen.G,Breeze,10,13,7,3,0,9,4,0,2,Rex Regum Qeon,Attack,0,Rex Regum Qeon,-3,23,Gen.G,3,9,-6
361,Gen.G,Rex Regum Qeon,Rex Regum Qeon,Gen.G,Icebox,13,11,8,5,0,7,4,0,3,Rex Regum Qeon,Defense,0,Gen.G,2,24,,8,4,4
362,Team Secret,TALON,Team Secret,TALON,Breeze,13,8,5,8,0,4,4,0,1,TALON,Attack,0,Team Secret,5,21,Team Secret,8,4,4
362,TALON,Team Secret,Team Secret,TALON,Ascent,7,13,7,0,0,8,5,0,2,Team Secret,Defense,0,Team Secret,-6,20,TALON,7,5,2
363,Global Esports,ZETA DIVISION,Global Esports,ZETA DIVISION,Bind,8,13,4,4,0,5,8,0,1,ZETA DIVISION,Defense,0,ZETA DIVISION,-5,21,Global Esports,4,8,-4
363,ZETA DIVISION,Global Esports,Global Esports,ZETA DIVISION,Lotus,13,3,9,4,0,0,3,0,2,Global Esports,Defense,0,ZETA DIVISION,10,16,ZETA DIVISION,9,3,6
364,Team Secret,Gen.G,Team Secret,Gen.G,Breeze,13,5,5,8,0,4,1,0,1,Gen.G,Attack,0,Team Secret,8,18,Team Secret,8,4,4
364,Gen.G,Team Secret,Team Secret,Gen.G,Lotus,13,9,9,4,0,8,1,0,2,Team Secret,Attack,0,Gen.G,4,22,Gen.G,4,8,-4
364,Gen.G,Team Secret,Team Secret,Gen.G,Icebox,15,13,4,8,3,4,8,1,3,Team Secret,Attack,1,Gen.G,2,28,,8,4,4
365,Team Secret,ZETA DIVISION,Team Secret,ZETA DIVISION,Icebox,13,1,11,2,0,0,1,0,1,ZETA DIVISION,Defense,0,Team Secret,12,14,Team Secret,11,1,10
365,ZETA DIVISION,Team Secret,Team Secret,ZETA DIVISION,Ascent,8,13,7,1,0,8,5,0,2,Team Secret,Defense,0,Team Secret,-5,21,ZETA DIVISION,7,5,2
366,Gen.G,ZETA DIVISION,Gen.G,ZETA DIVISION,Icebox,13,6,8,5,0,2,4,0,1,ZETA DIVISION,Defense,0,Gen.G,7,19,Gen.G,8,4,4
366,ZETA DIVISION,Gen.G,Gen.G,ZETA DIVISION,Ascent,4,13,2,2,0,3,10,0,2,Gen.G,Defense,0,Gen.G,-9,17,ZETA DIVISION,2,10,-8
367,Paper Rex,T1,Paper Rex,T1,Split,16,14,8,4,4,8,4,2,1,T1,Attack,1,Paper Rex,2,30,Paper Rex,4,8,-4
367,T1,Paper Rex,Paper Rex,T1,Ascent,6,13,2,4,0,8,5,0,2,Paper Rex,Attack,0,Paper Rex,-7,19,T1,4,8,-4
368,DRX,Gen.G,DRX,Gen.G,Bind,12,14,7,5,0,7,5,2,1,Gen.G,Defense,1,Gen.G,-2,26,DRX,7,5,2
368,Gen.G,DRX,DRX,Gen.G,Lotus,13,8,9,4,0,5,3,0,2,DRX,Defense,0,Gen.G,5,21,Gen.G,9,3,6
369,Gen.G,Paper Rex,Gen.G,Paper Rex,Ascent,13,5,6,7,0,5,0,0,1,Paper Rex,Attack,0,Gen.G,8,18,Gen.G,7,5,2
369,Paper Rex,Gen.G,Gen.G,Paper Rex,Split,13,4,8,5,0,0,4,0,2,Gen.G,Defense,0,Paper Rex,9,17,Paper Rex,8,4,4
369,Gen.G,Paper Rex,Gen.G,Paper Rex,Lotus,13,11,8,5,0,7,4,0,3,Paper Rex,Attack,0,Gen.G,2,24,Gen.G,5,7,-2
369,Paper Rex,Gen.G,Gen.G,Paper Rex,Bind,4,13,0,4,0,8,5,0,4,Gen.G,Attack,0,Gen.G,-9,17,Paper Rex,4,8,-4
370,Team Heretics,FUT Esports,Team Heretics,FUT Esports,Lotus,13,11,8,5,0,7,4,0,1,FUT Esports,Attack,0,Team Heretics,2,24,Team Heretics,5,7,-2
370,FUT Esports,Team Heretics,Team Heretics,FUT Esports,Bind,10,13,5,5,0,7,6,0,2,Team Heretics,Attack,0,Team Heretics,-3,23,FUT Esports,5,7,-2
371,Karmine Corp,GIANTX,Karmine Corp,GIANTX,Split,13,11,7,6,0,6,5,0,1,GIANTX,Attack,0,Karmine Corp,2,24,Karmine Corp,6,6,0
371,GIANTX,Karmine Corp,Karmine Corp,GIANTX,Sunset,13,10,7,6,0,5,5,0,2,Karmine Corp,Defense,0,GIANTX,3,23,GIANTX,7,5,2
371,GIANTX,Karmine Corp,Karmine Corp,GIANTX,Lotus,4,13,3,1,0,4,9,0,3,Karmine Corp,Defense,0,Karmine Corp,-9,17,,3,9,-6
372,Natus Vincere,BBL Esports,Natus Vincere,BBL Esports,Bind,8,13,4,4,0,5,8,0,1,BBL Esports,Defense,0,BBL Esports,-5,21,Natus Vincere,4,8,-4
372,BBL Esports,Natus Vincere,Natus Vincere,BBL Esports,Ascent,6,13,6,0,0,7,6,0,2,Natus Vincere,Defense,0,Natus Vincere,-7,19,BBL Esports,6,6,0
372,BBL Esports,Natus Vincere,Natus Vincere,BBL Esports,Breeze,6,13,3,3,0,4,9,0,3,Natus Vincere,Defense,0,Natus Vincere,-7,19,,3,9,-6
373,Team Liquid,KOI,Team Liquid,KOI,Icebox,13,10,8,5,0,7,3,0,1,KOI,Attack,0,Team Liquid,3,23,Team Liquid,5,7,-2
373,KOI,Team Liquid,Team Liquid,KOI,Bind,11,13,7,4,0,8,5,0,2,Team Liquid,Defense,0,Team Liquid,-2,24,KOI,7,5,2
374,Team Vitality,Gentle Mates,Team Vitality,Gentle Mates,Sunset,13,10,8,5,0,6,4,0,1,Gentle Mates,Defense,0,Team Vitality,3,23,Team Vitality,8,4,4
374,Gentle Mates,Team Vitality,Team Vitality,Gentle Mates,Lotus,7,13,5,2,0,6,7,0,2,Team Vitality,Defense,0,Team Vitality,-6,20,Gentle Mates,5,7,-2
375,Karmine Corp,Team Heretics,Karmine Corp,Team Heretics,Split,4,13,3,1,0,4,9,0,1,Team Heretics,Defense,0,Team Heretics,-9,17,Karmine Corp,3,9,-6
375,Team Heretics,Karmine Corp,Karmine Corp,Team Heretics,Lotus,13,4,5,8,0,4,0,0,2,Karmine Corp,Attack,0,Team Heretics,9,17,Team Heretics,8,4,4
376,GIANTX,FUT Esports,GIANTX,FUT Esports,Split,6,13,4,2,0,5,8,0,1,FUT Esports,Defense,0,FUT Esports,-7,19,GIANTX,4,8,-4
376,FUT Esports,GIANTX,GIANTX,FUT Esports,Icebox,8,13,3,5,0,7,6,0,2,GIANTX,Attack,0,GIANTX,-5,21,FUT Esports,5,7,-2
376,FUT Esports,GIANTX,GIANTX,FUT Esports,Sunset,13,7,7,6,0,2,5,0,3,GIANTX,Defense,0,FUT Esports,6,20,,7,5,2
377,Team Liquid,Natus Vincere,Team Liquid,Natus Vincere,Split,7,13,7,0,0,8,5,0,1,Natus Vincere,Defense,0,Natus Vincere,-6,20,Team Liquid,7,5,2
377,Natus Vincere,Team Liquid,Team Liquid,Natus Vincere,Breeze,13,7,6,7,0,1,6,0,2,Team Liquid,Defense,0,Natus Vincere,6,20,Natus Vincere,6,6,0
378,BBL Esports,KOI,BBL Esports,KOI,Bind,5,13,3,2,0,10,3,0,1,KOI,Attack,0,KOI,-8,18,BBL Esports,2,10,-8
378,KOI,BBL Esports,BBL Esports,KOI,Split,13,10,6,7,0,4,6,0,2,BBL Esports,Defense,0,KOI,3,23,KOI,6,6,0
379,FNATIC,Team Vitality,FNATIC,Team Vitality,Lotus,14,12,8,4,2,8,4,0,1,Team Vitality,Defense,1,FNATIC,2,26,FNATIC,8,4,4
379,Team Vitality,FNATIC,FNATIC,Team Vitality,Ascent,5,13,5,0,0,6,7,0,2,FNATIC,Defense,0,FNATIC,-8,18,Team Vitality,5,7,-2
380,Gentle Mates,Team Vitality,Gentle Mates,Team Vitality,Breeze,13,4,10,3,0,2,2,0,1,Team Vitality,Defense,0,Gentle Mates,9,17,Gentle Mates,10,2,8
380,Team Vitality,Gentle Mates,Gentle Mates,Team Vitality,Lotus,15,13,7,5,3,7,5,1,2,Gentle Mates,Attack,1,Team Vitality,2,28,Team Vitality,5,7,-2
380,Team Vitality,Gentle Mates,Gentle Mates,Team Vitality,Sunset,13,3,11,2,0,2,1,0,3,Gentle Mates,Defense,0,Team Vitality,10,16,,11,1,10
381,FUT Esports,Karmine Corp,FUT Esports,Karmine Corp,Lotus,18,20,6,6,6,6,6,8,1,Karmine Corp,Attack,1,Karmine Corp,-2,38,FUT Esports,6,6,0
381,Karmine Corp,FUT Esports,FUT Esports,Karmine Corp,Bind,4,13,1,3,0,9,4,0,2,FUT Esports,Attack,0,FUT Esports,-9,17,Karmine Corp,3,9,-6
381,Karmine Corp,FUT Esports,FUT Esports,Karmine Corp,Sunset,13,7,3,10,0,2,5,0,3,FUT Esports,Attack,0,Karmine Corp,6,20,,10,2,8
382,KOI,Team Liquid,KOI,Team Liquid,Sunset,13,11,5,8,0,4,7,0,1,Team Liquid,Defense,0,KOI,2,24,KOI,5,7,-2
382,Team Liquid,KOI,KOI,Team Liquid,Icebox,14,12,6,6,2,6,6,0,2,KOI,Attack,1,Team Liquid,2,26,Team Liquid,6,6,0
382,Team Liquid,KOI,KOI,Team Liquid,Split,10,13,5,5,0,6,7,0,3,KOI,Defense,0,KOI,-3,23,,5,7,-2
383,Karmine Corp,Team Vitality,Karmine Corp,Team Vitality,Sunset,13,8,5,8,0,4,4,0,1,Team Vitality,Attack,0,Karmine Corp,5,21,Karmine Corp,8,4,4
383,Team Vitality,Karmine Corp,Karmine Corp,Team Vitality,Ascent,13,15,7,5,1,7,5,3,2,Karmine Corp,Attack,1,Karmine Corp,-2,28,Team Vitality,5,7,-2
384,KOI,Team Vitality,KOI,Team Vitality,Sunset,9,13,7,2,0,10,3,0,1,Team Vitality,Attack,0,Team Vitality,-4,22,KOI,2,10,-8
384,Team Vitality,KOI,KOI,Team Vitality,Breeze,13,6,6,7,0,0,6,0,2,KOI,Defense,0,Team Vitality,7,19,Team Vitality,6,6,0
385,Karmine Corp,KOI,Karmine Corp,KOI,Sunset,13,4,5,8,0,4,0,0,1,KOI,Attack,0,Karmine Corp,9,17,Karmine Corp,8,4,4
385,KOI,Karmine Corp,Karmine Corp,KOI,Bind,7,13,4,3,0,9,4,0,2,Karmine Corp,Attack,0,Karmine Corp,-6,20,KOI,3,9,-6
386,Team Heretics,Natus Vincere,Team Heretics,Natus Vincere,Sunset,16,14,4,8,4,4,8,2,1,Natus Vincere,Defense,1,Team Heretics,2,30,Team Heretics,4,8,-4
386,Natus Vincere,Team Heretics,Team Heretics,Natus Vincere,Breeze,4,13,2,2,0,10,3,0,2,Team Heretics,Attack,0,Team Heretics,-9,17,Natus Vincere,2,10,-8
387,FNATIC,Karmine Corp,FNATIC,Karmine Corp,Lotus,10,13,4,6,0,5,8,0,1,Karmine Corp,Defense,0,Karmine Corp,-3,23,FNATIC,4,8,-4
387,Karmine Corp,FNATIC,FNATIC,Karmine Corp,Split,13,8,7,6,0,3,5,0,2,FNATIC,Defense,0,Karmine Corp,5,21,Karmine Corp,7,5,2
388,Karmine Corp,Team Heretics,Karmine Corp,Team Heretics,Sunset,9,13,3,6,0,4,9,0,1,Team Heretics,Defense,0,Team Heretics,-4,22,Karmine Corp,3,9,-6
388,Team Heretics,Karmine Corp,Karmine Corp,Team Heretics,Lotus,7,13,6,1,0,11,2,0,2,Karmine Corp,Attack,0,Karmine Corp,-6,20,Team Heretics,1,11,-10
388,Karmine Corp,Team Heretics,Karmine Corp,Team Heretics,Icebox,13,7,5,8,0,4,3,0,3,Team Heretics,Attack,0,Karmine Corp,6,20,Karmine Corp,8,4,4
388,Team Heretics,Karmine Corp,Karmine Corp,Team Heretics,Split,5,13,4,1,0,5,8,0,4,Karmine Corp,Defense,0,Karmine Corp,-8,18,Team Heretics,4,8,-4
389,TYLOO,Trace Esports,TYLOO,Trace Esports,Ascent,4,13,4,0,0,5,8,0,1,Trace Esports,Defense,0,Trace Esports,-9,17,TYLOO,4,8,-4
389,Trace Esports,TYLOO,TYLOO,Trace Esports,Sunset,13,3,2,11,0,1,2,0,2,TYLOO,Attack,0,Trace Esports,10,16,Trace Esports,11,1,10
390,Nova Esports,FunPlus Phoenix,Nova Esports,FunPlus Phoenix,Sunset,10,13,5,5,0,7,6,0,2,FunPlus Phoenix,Attack,0,FunPlus Phoenix,-3,23,Nova Esports,5,7,-2
390,FunPlus Phoenix,Nova Esports,Nova Esports,FunPlus Phoenix,Lotus,13,5,6,7,0,5,0,0,1,Nova Esports,Attack,0,FunPlus Phoenix,8,18,FunPlus Phoenix,7,5,2
391,JDG Esports,Titan Esports Club,JDG Esports,Titan Esports Club,Lotus,8,13,6,2,0,7,6,0,1,Titan Esports Club,Defense,0,Titan Esports Club,-5,21,JDG Esports,6,6,0
391,Titan Esports Club,JDG Esports,JDG Esports,Titan Esports Club,Bind,16,14,4,8,4,4,8,2,2,JDG Esports,Defense,1,Titan Esports Club,2,30,Titan Esports Club,4,8,-4
392,All Gamers,Dragon Ranger Gaming,All Gamers,Dragon Ranger Gaming,Sunset,11,13,7,4,0,8,5,0,1,Dragon Ranger Gaming,Defense,0,Dragon Ranger Gaming,-2,24,All Gamers,7,5,2
392,Dragon Ranger Gaming,All Gamers,All Gamers,Dragon Ranger Gaming,Ascent,13,4,4,9,0,3,1,0,2,All Gamers,Attack,0,Dragon Ranger Gaming,9,17,Dragon Ranger Gaming,9,3,6
393,Bilibili Gaming,Wolves Esports,Bilibili Gaming,Wolves Esports,Ascent,9,13,3,6,0,4,9,0,1,Wolves Esports,Defense,0,Wolves Esports,-4,22,Bilibili Gaming,3,9,-6
393,Wolves Esports,Bilibili Gaming,Bilibili Gaming,Wolves Esports,Icebox,13,7,7,6,0,2,5,0,2,Bilibili Gaming,Defense,0,Wolves Esports,6,20,Wolves Esports,7,5,2
394,TYLOO,Nova Esports,TYLOO,Nova Esports,Ascent,11,13,6,5,0,7,6,0,1,Nova Esports,Attack,0,Nova Esports,-2,24,TYLOO,5,7,-2
394,Nova Esports,TYLOO,TYLOO,Nova Esports,Split,13,11,7,6,0,6,5,0,2,TYLOO,Defense,0,Nova Esports,2,24,Nova Esports,7,5,2
395,All Gamers,JDG Esports,All Gamers,JDG Esports,Icebox,11,13,5,6,0,6,7,0,1,JDG Esports,Defense,0,JDG Esports,-2,24,All Gamers,5,7,-2
395,JDG Esports,All Gamers,All Gamers,JDG Esports,Sunset,13,8,6,7,0,2,6,0,2,All Gamers,Defense,0,JDG Esports,5,21,JDG Esports,6,6,0
396,FunPlus Phoenix,Trace Esports,FunPlus Phoenix,Trace Esports,Sunset,13,11,8,5,0,7,4,0,1,Trace Esports,Attack,0,FunPlus Phoenix,2,24,FunPlus Phoenix,5,7,-2
396,Trace Esports,FunPlus Phoenix,FunPlus Phoenix,Trace Esports,Bind,13,11,8,5,0,7,4,0,2,FunPlus Phoenix,Defense,0,Trace Esports,2,24,Trace Esports,8,4,4
396,Trace Esports,FunPlus Phoenix,FunPlus Phoenix,Trace Esports,Lotus,10,13,5,5,0,7,6,0,3,FunPlus Phoenix,Attack,0,FunPlus Phoenix,-3,23,,5,7,-2
397,Dragon Ranger Gaming,Titan Esports Club,Dragon Ranger Gaming,Titan Esports Club,Icebox,13,11,2,11,0,1,10,0,1,Titan Esports Club,Defense,0,Dragon Ranger Gaming,2,24,Dragon Ranger Gaming,2,10,-8
397,Titan Esports Club,Dragon Ranger Gaming,Dragon Ranger Gaming,Titan Esports Club,Split,13,8,7,6,0,6,2,0,2,Dragon Ranger Gaming,Attack,0,Titan Esports Club,5,21,Titan Esports Club,6,6,0
397,Titan Esports Club,Dragon Ranger Gaming,Dragon Ranger Gaming,Titan Esports Club,Bind,10,13,4,6,0,6,7,0,3,Dragon Ranger Gaming,Attack,0,Dragon Ranger Gaming,-3,23,,6,6,0
398,EDward Gaming,Wolves Esports,EDward Gaming,Wolves Esports,Bind,13,10,6,7,0,5,5,0,1,Wolves Esports,Attack,0,EDward Gaming,3,23,EDward Gaming,7,5,2
398,Wolves Esports,EDward Gaming,EDward Gaming,Wolves Esports,Ascent,13,10,6,7,0,4,6,0,2,EDward Gaming,Defense,0,Wolves Esports,3,23,Wolves Esports,6,6,0
398,Wolves Esports,EDward Gaming,EDward Gaming,Wolves Esports,Breeze,11,13,4,7,0,5,8,0,3,EDward Gaming,Attack,0,EDward Gaming,-2,24,,7,5,2
399,Nova Esports,Trace Esports,Nova Esports,Trace Esports,Split,5,13,5,0,0,6,7,0,1,Trace Esports,Defense,0,Trace Esports,-8,18,Nova Esports,5,7,-2
399,Trace Esports,Nova Esports,Nova Esports,Trace Esports,Lotus,13,4,5,8,0,4,0,0,2,Nova Esports,Attack,0,Trace Esports,9,17,Trace Esports,8,4,4
400,JDG Esports,Titan Esports Club,JDG Esports,Titan Esports Club,Bind,13,5,8,5,0,1,4,0,1,Titan Esports Club,Defense,0,JDG Esports,8,18,JDG Esports,8,4,4
400,Titan Esports Club,JDG Esports,JDG Esports,Titan Esports Club,Icebox,14,12,7,5,2,7,5,0,2,JDG Esports,Defense,1,Titan Esports Club,2,26,Titan Esports Club,7,5,2
400,Titan Esports Club,JDG Esports,JDG Esports,Titan Esports Club,Lotus,13,10,7,6,0,6,4,0,3,JDG Esports,Attack,0,Titan Esports Club,3,23,,6,6,0
401,Bilibili Gaming,Wolves Esports,Bilibili Gaming,Wolves Esports,Sunset,13,9,5,8,0,2,7,0,1,Wolves Esports,Defense,0,Bilibili Gaming,4,22,Bilibili Gaming,5,7,-2
401,Wolves Esports,Bilibili Gaming,Bilibili Gaming,Wolves Esports,Icebox,10,13,3,7,0,4,9,0,2,Bilibili Gaming,Defense,0,Bilibili Gaming,-3,23,Wolves Esports,3,9,-6
402,Titan Esports Club,Trace Esports,Titan Esports Club,Trace Esports,Breeze,18,16,7,5,6,7,5,4,1,Trace Esports,Attack,1,Titan Esports Club,2,34,Titan Esports Club,5,7,-2
402,Trace Esports,Titan Esports Club,Titan Esports Club,Trace Esports,Lotus,13,6,10,3,0,4,2,0,2,Titan Esports Club,Defense,0,Trace Esports,7,19,Trace Esports,10,2,8
402,Trace Esports,Titan Esports Club,Titan Esports Club,Trace Esports,Split,13,8,9,4,0,5,3,0,3,Titan Esports Club,Defense,0,Trace Esports,5,21,,9,3,6
403,Titan Esports Club,Bilibili Gaming,Titan Esports Club,Bilibili Gaming,Lotus,3,13,3,0,0,4,9,0,1,Bilibili Gaming,Defense,0,Bilibili Gaming,-10,16,Titan Esports Club,3,9,-6
403,Bilibili Gaming,Titan Esports Club,Titan Esports Club,Bilibili Gaming,Ascent,13,8,7,6,0,3,5,0,2,Titan Esports Club,Defense,0,Bilibili Gaming,5,21,Bilibili Gaming,7,5,2
404,Trace Esports,Bilibili Gaming,Trace Esports,Bilibili Gaming,Lotus,11,13,3,8,0,4,9,0,1,Bilibili Gaming,Defense,0,Bilibili Gaming,-2,24,Trace Esports,3,9,-6
404,Bilibili Gaming,Trace Esports,Trace Esports,Bilibili Gaming,Sunset,13,15,6,6,1,6,6,3,2,Trace Esports,Attack,1,Trace Esports,-2,28,Bilibili Gaming,6,6,0
404,Bilibili Gaming,Trace Esports,Trace Esports,Bilibili Gaming,Bind,12,14,4,8,0,4,8,2,3,Trace Esports,Defense,1,Trace Esports,-2,26,,4,8,-4
405,Dragon Ranger Gaming,FunPlus Phoenix,Dragon Ranger Gaming,FunPlus Phoenix,Ascent,10,13,4,6,0,5,8,0,1,FunPlus Phoenix,Defense,0,FunPlus Phoenix,-3,23,Dragon Ranger Gaming,4,8,-4
405,FunPlus Phoenix,Dragon Ranger Gaming,Dragon Ranger Gaming,FunPlus Phoenix,Breeze,13,6,4,9,0,3,3,0,2,Dragon Ranger Gaming,Attack,0,FunPlus Phoenix,7,19,FunPlus Phoenix,9,3,6
406,Trace Esports,EDward Gaming,Trace Esports,EDward Gaming,Sunset,12,14,7,5,0,7,5,2,1,EDward Gaming,Attack,1,EDward Gaming,-2,26,Trace Esports,5,7,-2
406,EDward Gaming,Trace Esports,Trace Esports,EDward Gaming,Bind,13,6,8,5,0,2,4,0,2,Trace Esports,Defense,0,EDward Gaming,7,19,EDward Gaming,8,4,4
407,FunPlus Phoenix,EDward Gaming,FunPlus Phoenix,EDward Gaming,Breeze,12,14,5,7,0,5,7,2,1,EDward Gaming,Defense,1,EDward Gaming,-2,26,FunPlus Phoenix,5,7,-2
407,EDward Gaming,FunPlus Phoenix,FunPlus Phoenix,EDward Gaming,Split,13,6,7,6,0,1,5,0,2,FunPlus Phoenix,Defense,0,EDward Gaming,7,19,EDward Gaming,7,5,2
407,FunPlus Phoenix,EDward Gaming,FunPlus Phoenix,EDward Gaming,Icebox,13,8,7,6,0,6,2,0,3,EDward Gaming,Attack,0,FunPlus Phoenix,5,21,FunPlus Phoenix,6,6,0
407,EDward Gaming,FunPlus Phoenix,FunPlus Phoenix,EDward Gaming,Ascent,16,14,6,6,4,6,6,2,4,FunPlus Phoenix,Defense,1,EDward Gaming,2,30,EDward Gaming,6,6,0
408,FunPlus Phoenix,Karmine Corp,FunPlus Phoenix,Karmine Corp,Icebox,8,13,5,3,0,6,7,0,1,Karmine Corp,Defense,0,Karmine Corp,-5,21,FunPlus Phoenix,5,7,-2
408,Karmine Corp,FunPlus Phoenix,FunPlus Phoenix,Karmine Corp,Lotus,13,10,9,4,0,8,2,0,2,FunPlus Phoenix,Attack,0,Karmine Corp,3,23,Karmine Corp,4,8,-4
409,LOUD,Gen.G,LOUD,Gen.G,Icebox,11,13,5,6,0,6,7,0,1,Gen.G,Attack,0,Gen.G,-2,24,LOUD,6,6,0
409,Gen.G,LOUD,LOUD,Gen.G,Breeze,8,13,5,3,0,9,4,0,2,LOUD,Attack,0,LOUD,-5,21,Gen.G,3,9,-6
409,Gen.G,LOUD,LOUD,Gen.G,Ascent,13,5,9,4,0,2,3,0,3,LOUD,Defense,0,Gen.G,8,18,,9,3,6
410,Paper Rex,EDward Gaming,Paper Rex,EDward Gaming,Sunset,13,8,9,4,0,5,3,0,1,EDward Gaming,Defense,0,Paper Rex,5,21,Paper Rex,9,3,6
410,EDward Gaming,Paper Rex,Paper Rex,EDward Gaming,Bind,13,9,5,8,0,4,5,0,2,Paper Rex,Attack,0,EDward Gaming,4,22,EDward Gaming,8,4,4
410,EDward Gaming,Paper Rex,Paper Rex,EDward Gaming,Split,13,9,5,8,0,4,5,0,3,Paper Rex,Attack,0,EDward Gaming,4,22,,8,4,4
411,Sentinels,Team Heretics,Sentinels,Team Heretics,Lotus,13,9,9,4,0,8,1,0,1,Team Heretics,Attack,0,Sentinels,4,22,Sentinels,4,8,-4
411,Team Heretics,Sentinels,Sentinels,Team Heretics,Sunset,13,5,5,8,0,4,1,0,2,Sentinels,Attack,0,Team Heretics,8,18,Team Heretics,8,4,4
411,Team Heretics,Sentinels,Sentinels,Team Heretics,Bind,11,13,5,6,0,6,7,0,3,Sentinels,Attack,0,Sentinels,-2,24,,6,6,0
412,Sentinels,Karmine Corp,Sentinels,Karmine Corp,Split,13,8,6,7,0,2,6,0,1,Karmine Corp,Defense,0,Sentinels,5,21,Sentinels,6,6,0
412,Karmine Corp,Sentinels,Sentinels,Karmine Corp,Lotus,11,13,6,5,0,7,6,0,2,Sentinels,Attack,0,Sentinels,-2,24,Karmine Corp,5,7,-2
413,Gen.G,EDward Gaming,Gen.G,EDward Gaming,Icebox,8,13,4,4,0,8,5,0,1,EDward Gaming,Attack,0,EDward Gaming,-5,21,Gen.G,4,8,-4
413,EDward Gaming,Gen.G,Gen.G,EDward Gaming,Split,5,13,0,5,0,7,6,0,2,Gen.G,Attack,0,Gen.G,-8,18,EDward Gaming,5,7,-2
413,EDward Gaming,Gen.G,Gen.G,EDward Gaming,Breeze,6,13,5,1,0,11,2,0,3,Gen.G,Attack,0,Gen.G,-7,19,,1,11,-10
414,LOUD,FunPlus Phoenix,LOUD,FunPlus Phoenix,Sunset,13,5,5,8,0,4,1,0,1,FunPlus Phoenix,Attack,0,LOUD,8,18,LOUD,8,4,4
414,FunPlus Phoenix,LOUD,LOUD,FunPlus Phoenix,Breeze,11,13,4,7,0,5,8,0,2,LOUD,Attack,0,LOUD,-2,24,FunPlus Phoenix,7,5,2
415,Paper Rex,Team Heretics,Paper Rex,Team Heretics,Sunset,13,10,6,7,0,4,6,0,1,Team Heretics,Defense,0,Paper Rex,3,23,Paper Rex,6,6,0
415,Team Heretics,Paper Rex,Paper Rex,Team Heretics,Lotus,13,10,6,7,0,5,5,0,2,Paper Rex,Attack,0,Team Heretics,3,23,Team Heretics,7,5,2
415,Team Heretics,Paper Rex,Paper Rex,Team Heretics,Split,7,13,1,6,0,6,7,0,3,Paper Rex,Attack,0,Paper Rex,-6,20,,6,6,0
416,EDward Gaming,LOUD,EDward Gaming,LOUD,Icebox,2,13,1,1,0,11,2,0,1,LOUD,Attack,0,LOUD,-11,15,EDward Gaming,1,11,-10
416,LOUD,EDward Gaming,EDward Gaming,LOUD,Sunset,13,3,4,9,0,3,0,0,2,EDward Gaming,Attack,0,LOUD,10,16,LOUD,9,3,6
417,Paper Rex,Karmine Corp,Paper Rex,Karmine Corp,Bind,13,10,8,5,0,6,4,0,1,Karmine Corp,Defense,0,Paper Rex,3,23,Paper Rex,8,4,4
417,Karmine Corp,Paper Rex,Paper Rex,Karmine Corp,Lotus,13,6,5,8,0,4,2,0,2,Paper Rex,Attack,0,Karmine Corp,7,19,Karmine Corp,8,4,4
417,Karmine Corp,Paper Rex,Paper Rex,Karmine Corp,Ascent,12,14,5,7,0,5,7,2,3,Paper Rex,Attack,1,Paper Rex,-2,26,,7,5,2
418,Paper Rex,Gen.G,Paper Rex,Gen.G,Split,8,13,4,4,0,8,5,0,1,Gen.G,Attack,0,Gen.G,-5,21,Paper Rex,4,8,-4
418,Gen.G,Paper Rex,Paper Rex,Gen.G,Lotus,13,9,5,8,0,4,5,0,2,Paper Rex,Attack,0,Gen.G,4,22,Gen.G,8,4,4
419,Sentinels,LOUD,Sentinels,LOUD,Split,13,4,9,4,0,1,3,0,1,LOUD,Defense,0,Sentinels,9,17,Sentinels,9,3,6
419,LOUD,Sentinels,Sentinels,LOUD,Icebox,14,12,5,7,2,5,7,0,2,Sentinels,Attack,1,LOUD,2,26,LOUD,7,5,2
419,LOUD,Sentinels,Sentinels,LOUD,Sunset,12,14,7,5,0,7,5,2,3,Sentinels,Attack,1,Sentinels,-2,26,,5,7,-2
420,Sentinels,Gen.G,Sentinels,Gen.G,Split,5,13,1,4,0,8,5,0,1,Gen.G,Attack,0,Gen.G,-8,18,Sentinels,4,8,-4
420,Gen.G,Sentinels,Sentinels,Gen.G,Lotus,7,13,2,5,0,7,6,0,2,Sentinels,Attack,0,Sentinels,-6,20,Gen.G,5,7,-2
420,Gen.G,Sentinels,Sentinels,Gen.G,Breeze,13,3,4,9,0,3,0,0,3,Sentinels,Attack,0,Gen.G,10,16,,9,3,6
421,LOUD,Paper Rex,LOUD,Paper Rex,Ascent,11,13,5,6,0,6,7,0,1,Paper Rex,Attack,0,Paper Rex,-2,24,LOUD,6,6,0
421,Paper Rex,LOUD,LOUD,Paper Rex,Sunset,13,8,6,7,0,5,3,0,2,LOUD,Attack,0,Paper Rex,5,21,Paper Rex,7,5,2
422,Sentinels,Paper Rex,Sentinels,Paper Rex,Lotus,14,12,6,6,2,6,6,0,1,Paper Rex,Attack,1,Sentinels,2,26,Sentinels,6,6,0
422,Paper Rex,Sentinels,Sentinels,Paper Rex,Ascent,6,13,6,0,0,7,6,0,2,Sentinels,Defense,0,Sentinels,-7,19,Paper Rex,6,6,0
422,Sentinels,Paper Rex,Sentinels,Paper Rex,Split,5,13,4,1,0,5,8,0,3,Paper Rex,Defense,0,Paper Rex,-8,18,Sentinels,4,8,-4
422,Paper Rex,Sentinels,Sentinels,Paper Rex,Sunset,3,13,3,0,0,4,9,0,4,Sentinels,Defense,0,Sentinels,-10,16,Paper Rex,3,9,-6
423,Gen.G,Sentinels,Gen.G,Sentinels,Breeze,13,8,7,6,0,3,5,0,1,Sentinels,Defense,0,Gen.G,5,21,Gen.G,7,5,2
423,Sentinels,Gen.G,Gen.G,Sentinels,Bind,14,12,6,6,2,6,6,0,2,Gen.G,Attack,1,Sentinels,2,26,Sentinels,6,6,0
423,Gen.G,Sentinels,Gen.G,Sentinels,Ascent,13,8,6,7,0,2,6,0,3,Sentinels,Defense,0,Gen.G,5,21,Gen.G,6,6,0
423,Sentinels,Gen.G,Gen.G,Sentinels,Split,13,10,5,8,0,4,6,0,4,Gen.G,Attack,0,Sentinels,3,23,Sentinels,8,4,4
423,Gen.G,Sentinels,Gen.G,Sentinels,Icebox,6,13,5,1,0,6,7,0,5,Sentinels,Defense,0,Sentinels,-7,19,,5,7,-2
424,GIANTX,Karmine Corp,GIANTX,Karmine Corp,Breeze,4,13,3,1,0,4,9,0,1,Karmine Corp,Defense,0,Karmine Corp,-9,17,GIANTX,3,9,-6
424,Karmine Corp,GIANTX,GIANTX,Karmine Corp,Sunset,13,9,6,7,0,3,6,0,2,GIANTX,Defense,0,Karmine Corp,4,22,Karmine Corp,6,6,0
425,KOI,Team Liquid,KOI,Team Liquid,Split,9,13,8,1,0,9,4,0,1,Team Liquid,Defense,0,Team Liquid,-4,22,KOI,8,4,4
425,Team Liquid,KOI,KOI,Team Liquid,Ascent,13,7,8,5,0,3,4,0,2,KOI,Defense,0,Team Liquid,6,20,Team Liquid,8,4,4
426,Natus Vincere,Team Vitality,Natus Vincere,Team Vitality,Bind,13,9,7,6,0,4,5,0,1,Team Vitality,Defense,0,Natus Vincere,4,22,Natus Vincere,7,5,2
426,Team Vitality,Natus Vincere,Natus Vincere,Team Vitality,Lotus,4,13,1,3,0,9,4,0,2,Natus Vincere,Attack,0,Natus Vincere,-9,17,Team Vitality,3,9,-6
427,FNATIC,Team Heretics,FNATIC,Team Heretics,Icebox,4,13,1,3,0,9,4,0,1,Team Heretics,Attack,0,Team Heretics,-9,17,FNATIC,3,9,-6
427,Team Heretics,FNATIC,FNATIC,Team Heretics,Lotus,17,15,7,5,5,7,5,3,2,FNATIC,Attack,1,Team Heretics,2,32,Team Heretics,5,7,-2
428,FUT Esports,Team Liquid,FUT Esports,Team Liquid,Split,13,5,10,3,0,3,2,0,1,Team Liquid,Defense,0,FUT Esports,8,18,FUT Esports,10,2,8
428,Team Liquid,FUT Esports,FUT Esports,Team Liquid,Icebox,8,13,4,4,0,5,8,0,2,FUT Esports,Defense,0,FUT Esports,-5,21,Team Liquid,4,8,-4
429,BBL Esports,Gentle Mates,BBL Esports,Gentle Mates,Ascent,7,13,3,4,0,8,5,0,1,Gentle Mates,Attack,0,Gentle Mates,-6,20,BBL Esports,4,8,-4
429,Gentle Mates,BBL Esports,BBL Esports,Gentle Mates,Sunset,13,11,6,7,0,5,6,0,2,BBL Esports,Defense,0,Gentle Mates,2,24,Gentle Mates,6,6,0
430,FUT Esports,Karmine Corp,FUT Esports,Karmine Corp,Bind,11,13,6,5,0,7,6,0,1,Karmine Corp,Attack,0,Karmine Corp,-2,24,FUT Esports,5,7,-2
430,Karmine Corp,FUT Esports,FUT Esports,Karmine Corp,Lotus,8,13,5,3,0,9,4,0,2,FUT Esports,Attack,0,FUT Esports,-5,21,Karmine Corp,3,9,-6
430,Karmine Corp,FUT Esports,FUT Esports,Karmine Corp,Breeze,7,13,1,6,0,6,7,0,3,FUT Esports,Attack,0,FUT Esports,-6,20,,6,6,0
431,Team Vitality,Team Heretics,Team Vitality,Team Heretics,Breeze,13,9,7,6,0,6,3,0,1,Team Heretics,Attack,0,Team Vitality,4,22,Team Vitality,6,6,0
431,Team Heretics,Team Vitality,Team Vitality,Team Heretics,Sunset,13,11,6,7,0,5,6,0,2,Team Vitality,Attack,0,Team Heretics,2,24,Team Heretics,7,5,2
431,Team Heretics,Team Vitality,Team Vitality,Team Heretics,Icebox,9,13,5,4,0,8,5,0,3,Team Vitality,Attack,0,Team Vitality,-4,22,,4,8,-4
432,Team Liquid,Natus Vincere,Team Liquid,Natus Vincere,Lotus,13,10,5,8,0,4,6,0,1,Natus Vincere,Attack,0,Team Liquid,3,23,Team Liquid,8,4,4
432,Natus Vincere,Team Liquid,Team Liquid,Natus Vincere,Split,13,11,11,2,0,10,1,0,2,Team Liquid,Attack,0,Natus Vincere,2,24,Natus Vincere,2,10,-8
432,Natus Vincere,Team Liquid,Team Liquid,Natus Vincere,Ascent,13,5,9,4,0,2,3,0,3,Team Liquid,Defense,0,Natus Vincere,8,18,,9,3,6
433,KOI,BBL Esports,KOI,BBL Esports,Breeze,4,13,3,1,0,4,9,0,1,BBL Esports,Defense,0,BBL Esports,-9,17,KOI,3,9,-6
433,BBL Esports,KOI,KOI,BBL Esports,Icebox,13,3,4,9,0,3,0,0,2,KOI,Attack,0,BBL Esports,10,16,BBL Esports,9,3,6
434,GIANTX,FNATIC,GIANTX,FNATIC,Bind,5,13,0,5,0,7,6,0,1,FNATIC,Attack,0,FNATIC,-8,18,GIANTX,5,7,-2
434,FNATIC,GIANTX,GIANTX,FNATIC,Breeze,5,13,4,1,0,5,8,0,2,GIANTX,Defense,0,GIANTX,-8,18,FNATIC,4,8,-4
434,FNATIC,GIANTX,GIANTX,FNATIC,Split,13,7,9,4,0,4,3,0,3,GIANTX,Defense,0,FNATIC,6,20,,9,3,6
435,Karmine Corp,Gentle Mates,Karmine Corp,Gentle Mates,Split,13,6,4,9,0,3,3,0,1,Gentle Mates,Attack,0,Karmine Corp,7,19,Karmine Corp,9,3,6
435,Gentle Mates,Karmine Corp,Karmine Corp,Gentle Mates,Icebox,6,13,2,4,0,3,10,0,2,Karmine Corp,Defense,0,Karmine Corp,-7,19,Gentle Mates,2,10,-8
436,Gentle Mates,FNATIC,Gentle Mates,FNATIC,Breeze,6,13,3,3,0,4,9,0,1,FNATIC,Defense,0,FNATIC,-7,19,Gentle Mates,3,9,-6
436,FNATIC,Gentle Mates,Gentle Mates,FNATIC,Lotus,13,4,5,8,0,4,0,0,2,Gentle Mates,Attack,0,FNATIC,9,17,FNATIC,8,4,4
437,Natus Vincere,Karmine Corp,Natus Vincere,Karmine Corp,Bind,7,13,3,4,0,8,5,0,1,Karmine Corp,Attack,0,Karmine Corp,-6,20,Natus Vincere,4,8,-4
437,Karmine Corp,Natus Vincere,Natus Vincere,Karmine Corp,Sunset,7,13,2,5,0,7,6,0,2,Natus Vincere,Attack,0,Natus Vincere,-6,20,Karmine Corp,5,7,-2
437,Karmine Corp,Natus Vincere,Natus Vincere,Karmine Corp,Split,6,13,3,3,0,4,9,0,3,Natus Vincere,Defense,0,Natus Vincere,-7,19,,3,9,-6
438,BBL Esports,Team Heretics,BBL Esports,Team Heretics,Split,13,7,7,6,0,2,5,0,1,Team Heretics,Defense,0,BBL Esports,6,20,BBL Esports,7,5,2
438,Team Heretics,BBL Esports,BBL Esports,Team Heretics,Sunset,10,13,6,4,0,7,6,0,2,BBL Esports,Defense,0,BBL Esports,-3,23,Team Heretics,6,6,0
439,FUT Esports,Team Vitality,FUT Esports,Team Vitality,Ascent,13,7,8,5,0,3,4,0,1,Team Vitality,Defense,0,FUT Esports,6,20,FUT Esports,8,4,4
439,Team Vitality,FUT Esports,FUT Esports,Team Vitality,Icebox,13,9,7,6,0,6,3,0,2,FUT Esports,Attack,0,Team Vitality,4,22,Team Vitality,6,6,0
439,Team Vitality,FUT Esports,FUT Esports,Team Vitality,Sunset,13,9,6,7,0,3,6,0,3,FUT Esports,Defense,0,Team Vitality,4,22,,6,6,0
440,GIANTX,Team Liquid,GIANTX,Team Liquid,Lotus,16,14,7,5,4,7,5,2,1,Team Liquid,Defense,1,GIANTX,2,30,GIANTX,7,5,2
440,Team Liquid,GIANTX,GIANTX,Team Liquid,Icebox,13,7,9,4,0,4,3,0,2,GIANTX,Defense,0,Team Liquid,6,20,Team Liquid,9,3,6
440,Team Liquid,GIANTX,GIANTX,Team Liquid,Ascent,13,11,4,9,0,3,8,0,3,GIANTX,Defense,0,Team Liquid,2,24,,4,8,-4
441,FNATIC,KOI,FNATIC,KOI,Bind,13,11,10,3,0,9,2,0,1,KOI,Attack,0,FNATIC,2,24,FNATIC,3,9,-6
441,KOI,FNATIC,FNATIC,KOI,Icebox,4,13,0,4,0,8,5,0,2,FNATIC,Attack,0,FNATIC,-9,17,KOI,4,8,-4
442,Team Heretics,Team Liquid,Team Heretics,Team Liquid,Sunset,13,2,10,3,0,0,2,0,1,Team Liquid,Defense,0,Team Heretics,11,15,Team Heretics,10,2,8
442,Team Liquid,Team Heretics,Team Heretics,Team Liquid,Bind,7,13,5,2,0,6,7,0,2,Team Heretics,Defense,0,Team Heretics,-6,20,Team Liquid,5,7,-2
443,Team Vitality,Gentle Mates,Team Vitality,Gentle Mates,Icebox,5,13,4,1,0,5,8,0,1,Gentle Mates,Defense,0,Gentle Mates,-8,18,Team Vitality,4,8,-4
443,Gentle Mates,Team Vitality,Team Vitality,Gentle Mates,Sunset,13,5,3,10,0,2,3,0,2,Team Vitality,Attack,0,Gentle Mates,8,18,Gentle Mates,10,2,8
444,FUT Esports,FNATIC,FUT Esports,FNATIC,Split,13,7,6,7,0,5,2,0,1,FNATIC,Attack,0,FUT Esports,6,20,FUT Esports,7,5,2
444,FNATIC,FUT Esports,FUT Esports,FNATIC,Lotus,13,15,6,6,1,6,6,3,2,FUT Esports,Attack,1,FUT Esports,-2,28,FNATIC,6,6,0
445,Natus Vincere,BBL Esports,Natus Vincere,BBL Esports,Ascent,13,8,7,6,0,3,5,0,1,BBL Esports,Defense,0,Natus Vincere,5,21,Natus Vincere,7,5,2
445,BBL Esports,Natus Vincere,Natus Vincere,BBL Esports,Sunset,13,8,5,8,0,4,4,0,2,Natus Vincere,Attack,0,BBL Esports,5,21,BBL Esports,8,4,4
445,BBL Esports,Natus Vincere,Natus Vincere,BBL Esports,Split,13,9,6,7,0,3,6,0,3,Natus Vincere,Defense,0,BBL Esports,4,22,,6,6,0
446,GIANTX,Team Vitality,GIANTX,Team Vitality,Lotus,16,14,7,5,4,7,5,2,1,Team Vitality,Attack,1,GIANTX,2,30,GIANTX,5,7,-2
446,Team Vitality,GIANTX,GIANTX,Team Vitality,Breeze,13,7,9,4,0,4,3,0,2,GIANTX,Defense,0,Team Vitality,6,20,Team Vitality,9,3,6
446,Team Vitality,GIANTX,GIANTX,Team Vitality,Sunset,13,6,7,6,0,1,5,0,3,GIANTX,Defense,0,Team Vitality,7,19,,7,5,2
447,KOI,Karmine Corp,KOI,Karmine Corp,Sunset,7,13,3,4,0,8,5,0,1,Karmine Corp,Attack,0,Karmine Corp,-6,20,KOI,4,8,-4
447,Karmine Corp,KOI,KOI,Karmine Corp,Icebox,7,13,4,3,0,9,4,0,2,KOI,Attack,0,KOI,-6,20,Karmine Corp,3,9,-6
447,Karmine Corp,KOI,KOI,Karmine Corp,Bind,15,13,4,8,3,4,8,1,3,KOI,Attack,1,Karmine Corp,2,28,,8,4,4
448,GIANTX,BBL Esports,GIANTX,BBL Esports,Bind,13,6,7,6,0,1,5,0,1,BBL Esports,Defense,0,GIANTX,7,19,GIANTX,7,5,2
448,BBL Esports,GIANTX,GIANTX,BBL Esports,Sunset,11,13,5,6,0,6,7,0,2,GIANTX,Attack,0,GIANTX,-2,24,BBL Esports,6,6,0
449,Karmine Corp,Team Heretics,Karmine Corp,Team Heretics,Icebox,12,14,6,6,0,6,6,2,1,Team Heretics,Attack,1,Team Heretics,-2,26,Karmine Corp,6,6,0
449,Team Heretics,Karmine Corp,Karmine Corp,Team Heretics,Lotus,5,13,3,2,0,10,3,0,2,Karmine Corp,Attack,0,Karmine Corp,-8,18,Team Heretics,2,10,-8
449,Team Heretics,Karmine Corp,Karmine Corp,Team Heretics,Bind,13,9,9,4,0,8,1,0,3,Karmine Corp,Attack,0,Team Heretics,4,22,,4,8,-4
450,KOI,Team Vitality,KOI,Team Vitality,Split,13,5,6,7,0,5,0,0,1,Team Vitality,Attack,0,KOI,8,18,KOI,7,5,2
450,Team Vitality,KOI,KOI,Team Vitality,Breeze,13,7,6,7,0,1,6,0,2,KOI,Defense,0,Team Vitality,6,20,Team Vitality,6,6,0
450,Team Vitality,KOI,KOI,Team Vitality,Icebox,4,13,3,1,0,4,9,0,3,KOI,Defense,0,KOI,-9,17,,3,9,-6
451,FNATIC,Natus Vincere,FNATIC,Natus Vincere,Breeze,13,6,6,7,0,5,1,0,1,Natus Vincere,Attack,0,FNATIC,7,19,FNATIC,7,5,2
451,Natus Vincere,FNATIC,FNATIC,Natus Vincere,Ascent,13,8,9,4,0,5,3,0,2,FNATIC,Defense,0,Natus Vincere,5,21,Natus Vincere,9,3,6
451,Natus Vincere,FNATIC,FNATIC,Natus Vincere,Bind,13,3,4,9,0,3,0,0,3,FNATIC,Attack,0,Natus Vincere,10,16,,9,3,6
452,Team Liquid,Gentle Mates,Team Liquid,Gentle Mates,Lotus,13,4,8,5,0,0,4,0,1,Gentle Mates,Defense,0,Team Liquid,9,17,Team Liquid,8,4,4
452,Gentle Mates,Team Liquid,Team Liquid,Gentle Mates,Icebox,2,13,0,2,0,10,3,0,2,Team Liquid,Attack,0,Team Liquid,-11,15,Gentle Mates,2,10,-8
453,FUT Esports,BBL Esports,FUT Esports,BBL Esports,Bind,13,9,5,8,0,4,5,0,1,BBL Esports,Attack,0,FUT Esports,4,22,FUT Esports,8,4,4
453,BBL Esports,FUT Esports,FUT Esports,BBL Esports,Icebox,6,13,3,3,0,9,4,0,2,FUT Esports,Attack,0,FUT Esports,-7,19,BBL Esports,3,9,-6
454,Team Liquid,FNATIC,Team Liquid,FNATIC,Ascent,11,13,2,9,0,3,10,0,1,FNATIC,Attack,0,FNATIC,-2,24,Team Liquid,9,3,6
454,FNATIC,Team Liquid,Team Liquid,FNATIC,Icebox,12,14,5,7,0,5,7,2,2,Team Liquid,Defense,1,Team Liquid,-2,26,FNATIC,5,7,-2
454,FNATIC,Team Liquid,Team Liquid,FNATIC,Lotus,13,5,2,11,0,1,4,0,3,Team Liquid,Attack,0,FNATIC,8,18,,11,1,10
455,Team Heretics,Natus Vincere,Team Heretics,Natus Vincere,Lotus,13,11,8,5,0,7,4,0,1,Natus Vincere,Attack,0,Team Heretics,2,24,Team Heretics,5,7,-2
455,Natus Vincere,Team Heretics,Team Heretics,Natus Vincere,Split,9,13,6,3,0,7,6,0,2,Team Heretics,Defense,0,Team Heretics,-4,22,Natus Vincere,6,6,0
456,FNATIC,Karmine Corp,FNATIC,Karmine Corp,Breeze,13,11,10,3,0,9,2,0,1,Karmine Corp,Attack,0,FNATIC,2,24,FNATIC,3,9,-6
456,Karmine Corp,FNATIC,FNATIC,Karmine Corp,Bind,9,13,8,1,0,9,4,0,2,FNATIC,Defense,0,FNATIC,-4,22,Karmine Corp,8,4,4
457,Team Heretics,FUT Esports,Team Heretics,FUT Esports,Lotus,13,10,7,6,0,6,4,0,1,FUT Esports,Attack,0,Team Heretics,3,23,Team Heretics,6,6,0
457,FUT Esports,Team Heretics,Team Heretics,FUT Esports,Split,13,15,5,7,1,5,7,3,2,Team Heretics,Defense,1,Team Heretics,-2,28,FUT Esports,5,7,-2
458,Team Heretics,FNATIC,Team Heretics,FNATIC,Lotus,15,13,6,6,3,6,6,1,1,FNATIC,Defense,1,Team Heretics,2,28,Team Heretics,6,6,0
458,FNATIC,Team Heretics,Team Heretics,FNATIC,Breeze,4,13,4,0,0,5,8,0,2,Team Heretics,Defense,0,Team Heretics,-9,17,FNATIC,4,8,-4
459,Karmine Corp,FUT Esports,Karmine Corp,FUT Esports,Icebox,3,13,1,2,0,10,3,0,1,FUT Esports,Attack,0,FUT Esports,-10,16,Karmine Corp,2,10,-8
459,FUT Esports,Karmine Corp,Karmine Corp,FUT Esports,Sunset,13,10,5,8,0,4,6,0,2,Karmine Corp,Attack,0,FUT Esports,3,23,FUT Esports,8,4,4
460,FNATIC,FUT Esports,FNATIC,FUT Esports,Icebox,11,13,8,3,0,9,4,0,1,FUT Esports,Attack,0,FUT Esports,-2,24,FNATIC,3,9,-6
460,FUT Esports,FNATIC,FNATIC,FUT Esports,Bind,6,13,6,0,0,7,6,0,2,FNATIC,Defense,0,FNATIC,-7,19,FUT Esports,6,6,0
460,FNATIC,FUT Esports,FNATIC,FUT Esports,Breeze,13,11,7,6,0,6,5,0,3,FUT Esports,Attack,0,FNATIC,2,24,FNATIC,6,6,0
460,FUT Esports,FNATIC,FNATIC,FUT Esports,Split,12,14,4,8,0,4,8,2,4,FNATIC,Attack,1,FNATIC,-2,26,FUT Esports,8,4,4
461,Team Heretics,FNATIC,Team Heretics,FNATIC,Sunset,13,7,5,8,0,4,3,0,1,FNATIC,Attack,0,Team Heretics,6,20,Team Heretics,8,4,4
461,FNATIC,Team Heretics,Team Heretics,FNATIC,Bind,13,15,6,6,1,6,6,3,2,Team Heretics,Defense,1,Team Heretics,-2,28,FNATIC,6,6,0
461,Team Heretics,FNATIC,Team Heretics,FNATIC,Lotus,8,13,7,1,0,8,5,0,3,FNATIC,Defense,0,FNATIC,-5,21,Team Heretics,7,5,2
461,FNATIC,Team Heretics,Team Heretics,FNATIC,Split,13,5,7,6,0,0,5,0,4,Team Heretics,Defense,0,FNATIC,8,18,FNATIC,7,5,2
461,Team Heretics,FNATIC,Team Heretics,FNATIC,Breeze,8,13,4,4,0,5,8,0,5,FNATIC,Defense,0,FNATIC,-5,21,,4,8,-4
462,TYLOO,Bilibili Gaming,TYLOO,Bilibili Gaming,Bind,13,3,9,4,0,0,3,0,1,Bilibili Gaming,Defense,0,TYLOO,10,16,TYLOO,9,3,6
462,Bilibili Gaming,TYLOO,TYLOO,Bilibili Gaming,Icebox,13,6,6,7,0,5,1,0,2,TYLOO,Attack,0,Bilibili Gaming,7,19,Bilibili Gaming,7,5,2
462,Bilibili Gaming,TYLOO,TYLOO,Bilibili Gaming,Lotus,13,6,7,6,0,1,5,0,3,TYLOO,Defense,0,Bilibili Gaming,7,19,,7,5,2
463,Titan Esports Club,Wolves Esports,Titan Esports Club,Wolves Esports,Split,5,13,2,3,0,3,10,0,1,Wolves Esports,Defense,0,Wolves Esports,-8,18,Titan Esports Club,2,10,-8
463,Wolves Esports,Titan Esports Club,Titan Esports Club,Wolves Esports,Bind,12,14,8,4,0,8,4,2,2,Titan Esports Club,Attack,1,Titan Esports Club,-2,26,Wolves Esports,4,8,-4
463,Wolves Esports,Titan Esports Club,Titan Esports Club,Wolves Esports,Lotus,10,13,4,6,0,6,7,0,3,Titan Esports Club,Attack,0,Titan Esports Club,-3,23,,6,6,0
464,All Gamers,Dragon Ranger Gaming,All Gamers,Dragon Ranger Gaming,Icebox,11,13,4,7,0,5,8,0,1,Dragon Ranger Gaming,Attack,0,Dragon Ranger Gaming,-2,24,All Gamers,7,5,2
464,Dragon Ranger Gaming,All Gamers,All Gamers,Dragon Ranger Gaming,Sunset,11,13,5,6,0,6,7,0,2,All Gamers,Attack,0,All Gamers,-2,24,Dragon Ranger Gaming,6,6,0
464,Dragon Ranger Gaming,All Gamers,All Gamers,Dragon Ranger Gaming,Breeze,8,13,2,6,0,6,7,0,3,All Gamers,Attack,0,All Gamers,-5,21,,6,6,0
465,JDG Esports,EDward Gaming,JDG Esports,EDward Gaming,Ascent,5,13,0,5,0,7,6,0,1,EDward Gaming,Attack,0,EDward Gaming,-8,18,JDG Esports,5,7,-2
465,EDward Gaming,JDG Esports,JDG Esports,EDward Gaming,Bind,9,13,4,5,0,5,8,0,2,JDG Esports,Defense,0,JDG Esports,-4,22,EDward Gaming,4,8,-4
465,EDward Gaming,JDG Esports,JDG Esports,EDward Gaming,Split,13,11,8,5,0,7,4,0,3,JDG Esports,Defense,0,EDward Gaming,2,24,,8,4,4
466,Trace Esports,Nova Esports,Trace Esports,Nova Esports,Lotus,13,5,6,7,0,5,0,0,1,Nova Esports,Attack,0,Trace Esports,8,18,Trace Esports,7,5,2
466,Nova Esports,Trace Esports,Trace Esports,Nova Esports,Ascent,9,13,6,3,0,7,6,0,2,Trace Esports,Defense,0,Trace Esports,-4,22,Nova Esports,6,6,0
467,Wolves Esports,FunPlus Phoenix,Wolves Esports,FunPlus Phoenix,Ascent,8,13,5,3,0,6,7,0,1,FunPlus Phoenix,Defense,0,FunPlus Phoenix,-5,21,Wolves Esports,5,7,-2
467,FunPlus Phoenix,Wolves Esports,Wolves Esports,FunPlus Phoenix,Lotus,13,7,5,8,0,4,3,0,2,Wolves Esports,Attack,0,FunPlus Phoenix,6,20,FunPlus Phoenix,8,4,4
468,Nova Esports,JDG Esports,Nova Esports,JDG Esports,Sunset,8,13,6,2,0,7,6,0,1,JDG Esports,Defense,0,JDG Esports,-5,21,Nova Esports,6,6,0
468,JDG Esports,Nova Esports,Nova Esports,JDG Esports,Bind,9,13,5,4,0,6,7,0,2,Nova Esports,Defense,0,Nova Esports,-4,22,JDG Esports,5,7,-2
468,JDG Esports,Nova Esports,Nova Esports,JDG Esports,Ascent,4,13,2,2,0,3,10,0,3,Nova Esports,Defense,0,Nova Esports,-9,17,,2,10,-8
469,FunPlus Phoenix,Dragon Ranger Gaming,FunPlus Phoenix,Dragon Ranger Gaming,Breeze,13,11,5,8,0,4,7,0,1,Dragon Ranger Gaming,Attack,0,FunPlus Phoenix,2,24,FunPlus Phoenix,8,4,4
469,Dragon Ranger Gaming,FunPlus Phoenix,FunPlus Phoenix,Dragon Ranger Gaming,Icebox,13,9,9,4,0,6,3,0,2,FunPlus Phoenix,Defense,0,Dragon Ranger Gaming,4,22,Dragon Ranger Gaming,9,3,6
469,Dragon Ranger Gaming,FunPlus Phoenix,FunPlus Phoenix,Dragon Ranger Gaming,Sunset,3,13,2,1,0,11,2,0,3,FunPlus Phoenix,Attack,0,FunPlus Phoenix,-10,16,,1,11,-10
470,All Gamers,Wolves Esports,All Gamers,Wolves Esports,Breeze,9,13,5,4,0,6,7,0,1,Wolves Esports,Defense,0,Wolves Esports,-4,22,All Gamers,5,7,-2
470,Wolves Esports,All Gamers,All Gamers,Wolves Esports,Icebox,14,12,9,3,2,9,3,0,2,All Gamers,Attack,1,Wolves Esports,2,26,Wolves Esports,3,9,-6
471,Trace Esports,Bilibili Gaming,Trace Esports,Bilibili Gaming,Split,11,13,4,7,0,5,8,0,1,Bilibili Gaming,Defense,0,Bilibili Gaming,-2,24,Trace Esports,4,8,-4
471,Bilibili Gaming,Trace Esports,Trace Esports,Bilibili Gaming,Breeze,7,13,4,3,0,9,4,0,2,Trace Esports,Attack,0,Trace Esports,-6,20,Bilibili Gaming,3,9,-6
471,Bilibili Gaming,Trace Esports,Trace Esports,Bilibili Gaming,Bind,7,13,5,2,0,6,7,0,3,Trace Esports,Defense,0,Trace Esports,-6,20,,5,7,-2
472,Titan Esports Club,Dragon Ranger Gaming,Titan Esports Club,Dragon Ranger Gaming,Breeze,13,4,4,9,0,3,1,0,1,Dragon Ranger Gaming,Attack,0,Titan Esports Club,9,17,Titan Esports Club,9,3,6
472,Dragon Ranger Gaming,Titan Esports Club,Titan Esports Club,Dragon Ranger Gaming,Split,13,7,7,6,0,2,5,0,2,Titan Esports Club,Defense,0,Dragon Ranger Gaming,6,20,Dragon Ranger Gaming,7,5,2
472,Dragon Ranger Gaming,Titan Esports Club,Titan Esports Club,Dragon Ranger Gaming,Icebox,13,5,11,2,0,4,1,0,3,Titan Esports Club,Defense,0,Dragon Ranger Gaming,8,18,,11,1,10
473,EDward Gaming,TYLOO,EDward Gaming,TYLOO,Sunset,13,5,6,7,0,5,0,0,1,TYLOO,Attack,0,EDward Gaming,8,18,EDward Gaming,7,5,2
473,TYLOO,EDward Gaming,EDward Gaming,TYLOO,Bind,10,13,4,6,0,6,7,0,2,EDward Gaming,Attack,0,EDward Gaming,-3,23,TYLOO,6,6,0
474,Wolves Esports,Trace Esports,Wolves Esports,Trace Esports,Ascent,9,13,2,7,0,3,10,0,1,Trace Esports,Defense,0,Trace Esports,-4,22,Wolves Esports,2,10,-8
474,Trace Esports,Wolves Esports,Wolves Esports,Trace Esports,Lotus,13,9,5,8,0,4,5,0,2,Wolves Esports,Attack,0,Trace Esports,4,22,Trace Esports,8,4,4
475,Nova Esports,FunPlus Phoenix,Nova Esports,FunPlus Phoenix,Ascent,6,13,6,0,0,7,6,0,1,FunPlus Phoenix,Defense,0,FunPlus Phoenix,-7,19,Nova Esports,6,6,0
475,FunPlus Phoenix,Nova Esports,Nova Esports,FunPlus Phoenix,Lotus,13,4,8,5,0,0,4,0,2,Nova Esports,Defense,0,FunPlus Phoenix,9,17,FunPlus Phoenix,8,4,4
476,Bilibili Gaming,All Gamers,Bilibili Gaming,All Gamers,Lotus,11,13,5,6,0,6,7,0,1,All Gamers,Attack,0,All Gamers,-2,24,Bilibili Gaming,6,6,0
476,All Gamers,Bilibili Gaming,Bilibili Gaming,All Gamers,Bind,13,7,7,6,0,6,1,0,2,Bilibili Gaming,Attack,0,All Gamers,6,20,All Gamers,6,6,0
477,JDG Esports,Dragon Ranger Gaming,JDG Esports,Dragon Ranger Gaming,Breeze,7,13,3,4,0,4,9,0,1,Dragon Ranger Gaming,Defense,0,Dragon Ranger Gaming,-6,20,JDG Esports,3,9,-6
477,Dragon Ranger Gaming,JDG Esports,JDG Esports,Dragon Ranger Gaming,Icebox,5,13,3,2,0,10,3,0,2,JDG Esports,Attack,0,JDG Esports,-8,18,Dragon Ranger Gaming,2,10,-8
477,Dragon Ranger Gaming,JDG Esports,JDG Esports,Dragon Ranger Gaming,Bind,14,12,4,8,2,4,8,0,3,JDG Esports,Defense,1,Dragon Ranger Gaming,2,26,,4,8,-4
478,TYLOO,Nova Esports,TYLOO,Nova Esports,Icebox,10,13,6,4,0,7,6,0,1,Nova Esports,Defense,0,Nova Esports,-3,23,TYLOO,6,6,0
478,Nova Esports,TYLOO,TYLOO,Nova Esports,Ascent,12,14,5,7,0,5,7,2,2,TYLOO,Attack,1,TYLOO,-2,26,Nova Esports,7,5,2
478,Nova Esports,TYLOO,TYLOO,Nova Esports,Split,9,13,7,2,0,8,5,0,3,TYLOO,Defense,0,TYLOO,-4,22,,7,5,2
479,EDward Gaming,Titan Esports Club,EDward Gaming,Titan Esports Club,Ascent,13,5,8,5,0,1,4,0,1,Titan Esports Club,Defense,0,EDward Gaming,8,18,EDward Gaming,8,4,4
479,Titan Esports Club,EDward Gaming,EDward Gaming,Titan Esports Club,Sunset,5,13,3,2,0,10,3,0,2,EDward Gaming,Attack,0,EDward Gaming,-8,18,Titan Esports Club,2,10,-8
480,Bilibili Gaming,Titan Esports Club,Bilibili Gaming,Titan Esports Club,Sunset,11,13,6,5,0,7,6,0,1,Titan Esports Club,Attack,0,Titan Esports Club,-2,24,Bilibili Gaming,5,7,-2
480,Titan Esports Club,Bilibili Gaming,Bilibili Gaming,Titan Esports Club,Bind,8,13,4,4,0,8,5,0,2,Bilibili Gaming,Attack,0,Bilibili Gaming,-5,21,Titan Esports Club,4,8,-4
480,Titan Esports Club,Bilibili Gaming,Bilibili Gaming,Titan Esports Club,Icebox,13,6,5,8,0,4,2,0,3,Bilibili Gaming,Attack,0,Titan Esports Club,7,19,,8,4,4
481,Dragon Ranger Gaming,Trace Esports,Dragon Ranger Gaming,Trace Esports,Breeze,13,7,7,6,0,6,1,0,1,Trace Esports,Attack,0,Dragon Ranger Gaming,6,20,Dragon Ranger Gaming,6,6,0
481,Trace Esports,Dragon Ranger Gaming,Dragon Ranger Gaming,Trace Esports,Sunset,10,13,6,4,0,7,6,0,2,Dragon Ranger Gaming,Defense,0,Dragon Ranger Gaming,-3,23,Trace Esports,6,6,0
482,Wolves Esports,TYLOO,Wolves Esports,TYLOO,Sunset,13,11,7,6,0,6,5,0,1,TYLOO,Defense,0,Wolves Esports,2,24,Wolves Esports,7,5,2
482,TYLOO,Wolves Esports,Wolves Esports,TYLOO,Split,13,7,6,7,0,1,6,0,2,Wolves Esports,Defense,0,TYLOO,6,20,TYLOO,6,6,0
482,TYLOO,Wolves Esports,Wolves Esports,TYLOO,Ascent,10,13,5,5,0,6,7,0,3,Wolves Esports,Defense,0,Wolves Esports,-3,23,,5,7,-2
483,FunPlus Phoenix,EDward Gaming,FunPlus Phoenix,EDward Gaming,Breeze,4,13,1,3,0,9,4,0,1,EDward Gaming,Attack,0,EDward Gaming,-9,17,FunPlus Phoenix,3,9,-6
483,EDward Gaming,FunPlus Phoenix,FunPlus Phoenix,EDward Gaming,Bind,11,13,4,7,0,5,8,0,2,FunPlus Phoenix,Defense,0,FunPlus Phoenix,-2,24,EDward Gaming,4,8,-4
483,EDward Gaming,FunPlus Phoenix,FunPlus Phoenix,EDward Gaming,Ascent,4,13,4,0,0,5,8,0,3,FunPlus Phoenix,Defense,0,FunPlus Phoenix,-9,17,,4,8,-4
484,All Gamers,Nova Esports,All Gamers,Nova Esports,Lotus,16,14,8,4,4,8,4,2,1,Nova Esports,Defense,1,All Gamers,2,30,All Gamers,8,4,4
484,Nova Esports,All Gamers,All Gamers,Nova Esports,Bind,13,10,7,6,0,6,4,0,2,All Gamers,Attack,0,Nova Esports,3,23,Nova Esports,6,6,0
484,Nova Esports,All Gamers,All Gamers,Nova Esports,Split,7,13,4,3,0,5,8,0,3,All Gamers,Defense,0,All Gamers,-6,20,,4,8,-4
485,JDG Esports,Bilibili Gaming,JDG Esports,Bilibili Gaming,Icebox,8,13,6,2,0,7,6,0,1,Bilibili Gaming,Defense,0,Bilibili Gaming,-5,21,JDG Esports,6,6,0
485,Bilibili Gaming,JDG Esports,JDG Esports,Bilibili Gaming,Lotus,13,10,8,5,0,7,3,0,2,JDG Esports,Attack,0,Bilibili Gaming,3,23,Bilibili Gaming,5,7,-2
486,All Gamers,EDward Gaming,All Gamers,EDward Gaming,Sunset,6,13,3,3,0,9,4,0,1,EDward Gaming,Attack,0,EDward Gaming,-7,19,All Gamers,3,9,-6
486,EDward Gaming,All Gamers,All Gamers,EDward Gaming,Icebox,13,5,5,8,0,4,1,0,2,All Gamers,Attack,0,EDward Gaming,8,18,EDward Gaming,8,4,4
487,JDG Esports,Wolves Esports,JDG Esports,Wolves Esports,Lotus,13,8,7,6,0,6,2,0,1,Wolves Esports,Attack,0,JDG Esports,5,21,JDG Esports,6,6,0
487,Wolves Esports,JDG Esports,JDG Esports,Wolves Esports,Ascent,1,13,1,0,0,2,11,0,2,JDG Esports,Defense,0,JDG Esports,-12,14,Wolves Esports,1,11,-10
488,TYLOO,Dragon Ranger Gaming,TYLOO,Dragon Ranger Gaming,Bind,13,10,5,8,0,4,6,0,1,Dragon Ranger Gaming,Attack,0,TYLOO,3,23,TYLOO,8,4,4
488,Dragon Ranger Gaming,TYLOO,TYLOO,Dragon Ranger Gaming,Breeze,8,13,5,3,0,6,7,0,2,TYLOO,Defense,0,TYLOO,-5,21,Dragon Ranger Gaming,5,7,-2
489,Bilibili Gaming,FunPlus Phoenix,Bilibili Gaming,FunPlus Phoenix,Icebox,2,13,1,1,0,11,2,0,1,FunPlus Phoenix,Attack,0,FunPlus Phoenix,-11,15,Bilibili Gaming,1,11,-10
489,FunPlus Phoenix,Bilibili Gaming,Bilibili Gaming,FunPlus Phoenix,Lotus,13,6,11,2,0,5,1,0,2,Bilibili Gaming,Defense,0,FunPlus Phoenix,7,19,FunPlus Phoenix,11,1,10
490,Nova Esports,Titan Esports Club,Nova Esports,Titan Esports Club,Split,13,6,9,4,0,3,3,0,1,Titan Esports Club,Defense,0,Nova Esports,7,19,Nova Esports,9,3,6
490,Titan Esports Club,Nova Esports,Nova Esports,Titan Esports Club,Lotus,6,13,3,3,0,4,9,0,2,Nova Esports,Defense,0,Nova Esports,-7,19,Titan Esports Club,3,9,-6
491,Trace Esports,EDward Gaming,Trace Esports,EDward Gaming,Sunset,13,15,8,4,1,8,4,3,1,EDward Gaming,Attack,1,EDward Gaming,-2,28,Trace Esports,4,8,-4
491,EDward Gaming,Trace Esports,Trace Esports,EDward Gaming,Breeze,14,12,7,5,2,7,5,0,2,Trace Esports,Attack,1,EDward Gaming,2,26,EDward Gaming,5,7,-2
492,Trace Esports,All Gamers,Trace Esports,All Gamers,Sunset,13,9,5,8,0,4,5,0,1,All Gamers,Attack,0,Trace Esports,4,22,Trace Esports,8,4,4
492,All Gamers,Trace Esports,Trace Esports,All Gamers,Breeze,7,13,4,3,0,9,4,0,2,Trace Esports,Attack,0,Trace Esports,-6,20,All Gamers,3,9,-6
493,Nova Esports,Dragon Ranger Gaming,Nova Esports,Dragon Ranger Gaming,Bind,8,13,6,2,0,7,6,0,1,Dragon Ranger Gaming,Defense,0,Dragon Ranger Gaming,-5,21,Nova Esports,6,6,0
493,Dragon Ranger Gaming,Nova Esports,Nova Esports,Dragon Ranger Gaming,Ascent,13,7,7,6,0,2,5,0,2,Nova Esports,Defense,0,Dragon Ranger Gaming,6,20,Dragon Ranger Gaming,7,5,2
494,Trace Esports,FunPlus Phoenix,Trace Esports,FunPlus Phoenix,Bind,10,13,8,2,0,9,4,0,1,FunPlus Phoenix,Defense,0,FunPlus Phoenix,-3,23,Trace Esports,8,4,4
494,FunPlus Phoenix,Trace Esports,Trace Esports,FunPlus Phoenix,Lotus,13,8,6,7,0,5,3,0,2,Trace Esports,Attack,0,FunPlus Phoenix,5,21,FunPlus Phoenix,7,5,2
495,Dragon Ranger Gaming,EDward Gaming,Dragon Ranger Gaming,EDward Gaming,Ascent,3,13,0,3,0,9,4,0,1,EDward Gaming,Attack,0,EDward Gaming,-10,16,Dragon Ranger Gaming,3,9,-6
495,EDward Gaming,Dragon Ranger Gaming,Dragon Ranger Gaming,EDward Gaming,Split,13,9,5,8,0,2,7,0,2,Dragon Ranger Gaming,Defense,0,EDward Gaming,4,22,EDward Gaming,5,7,-2
496,FunPlus Phoenix,EDward Gaming,FunPlus Phoenix,EDward Gaming,Icebox,13,10,6,7,0,5,5,0,1,EDward Gaming,Attack,0,FunPlus Phoenix,3,23,FunPlus Phoenix,7,5,2
496,EDward Gaming,FunPlus Phoenix,FunPlus Phoenix,EDward Gaming,Breeze,12,14,9,3,0,9,3,2,2,FunPlus Phoenix,Defense,1,FunPlus Phoenix,-2,26,EDward Gaming,9,3,6
497,Trace Esports,Dragon Ranger Gaming,Trace Esports,Dragon Ranger Gaming,Sunset,13,6,8,5,0,2,4,0,1,Dragon Ranger Gaming,Defense,0,Trace Esports,7,19,Trace Esports,8,4,4
497,Dragon Ranger Gaming,Trace Esports,Trace Esports,Dragon Ranger Gaming,Split,13,8,7,6,0,3,5,0,2,Trace Esports,Defense,0,Dragon Ranger Gaming,5,21,Dragon Ranger Gaming,7,5,2
497,Dragon Ranger Gaming,Trace Esports,Trace Esports,Dragon Ranger Gaming,Bind,13,7,6,7,0,5,2,0,3,Trace Esports,Attack,0,Dragon Ranger Gaming,6,20,,7,5,2
498,EDward Gaming,Dragon Ranger Gaming,EDward Gaming,Dragon Ranger Gaming,Breeze,13,10,8,5,0,6,4,0,1,Dragon Ranger Gaming,Defense,0,EDward Gaming,3,23,EDward Gaming,8,4,4
498,Dragon Ranger Gaming,EDward Gaming,EDward Gaming,Dragon Ranger Gaming,Split,3,13,2,1,0,3,10,0,2,EDward Gaming,Defense,0,EDward Gaming,-10,16,Dragon Ranger Gaming,2,10,-8
498,EDward Gaming,Dragon Ranger Gaming,EDward Gaming,Dragon Ranger Gaming,Ascent,2,13,2,0,0,3,10,0,3,Dragon Ranger Gaming,Defense,0,Dragon Ranger Gaming,-11,15,EDward Gaming,2,10,-8
498,Dragon Ranger Gaming,EDward Gaming,EDward Gaming,Dragon Ranger Gaming,Bind,6,13,1,5,0,7,6,0,4,EDward Gaming,Attack,0,EDward Gaming,-7,19,Dragon Ranger Gaming,5,7,-2
499,FunPlus Phoenix,EDward Gaming,FunPlus Phoenix,EDward Gaming,Lotus,13,6,4,9,0,3,3,0,1,EDward Gaming,Attack,0,FunPlus Phoenix,7,19,FunPlus Phoenix,9,3,6
499,EDward Gaming,FunPlus Phoenix,FunPlus Phoenix,EDward Gaming,Bind,13,9,8,5,0,7,2,0,2,FunPlus Phoenix,Attack,0,EDward Gaming,4,22,EDward Gaming,5,7,-2
499,FunPlus Phoenix,EDward Gaming,FunPlus Phoenix,EDward Gaming,Icebox,12,14,8,4,0,8,4,2,3,EDward Gaming,Defense,1,EDward Gaming,-2,26,FunPlus Phoenix,8,4,4
499,EDward Gaming,FunPlus Phoenix,FunPlus Phoenix,EDward Gaming,Breeze,13,8,7,6,0,3,5,0,4,FunPlus Phoenix,Defense,0,EDward Gaming,5,21,EDward Gaming,7,5,2
500,ZETA DIVISION,Global Esports,ZETA DIVISION,Global Esports,Sunset,13,1,2,11,0,1,0,0,1,Global Esports,Attack,0,ZETA DIVISION,12,14,ZETA DIVISION,11,1,10
500,Global Esports,ZETA DIVISION,ZETA DIVISION,Global Esports,Icebox,13,10,5,8,0,4,6,0,2,ZETA DIVISION,Attack,0,Global Esports,3,23,Global Esports,8,4,4
500,Global Esports,ZETA DIVISION,ZETA DIVISION,Global Esports,Ascent,8,13,6,2,0,7,6,0,3,ZETA DIVISION,Defense,0,ZETA DIVISION,-5,21,,6,6,0
501,Team Secret,DRX,Team Secret,DRX,Sunset,8,13,5,3,0,9,4,0,1,DRX,Attack,0,DRX,-5,21,Team Secret,3,9,-6
501,DRX,Team Secret,Team Secret,DRX,Lotus,13,8,6,7,0,5,3,0,2,Team Secret,Attack,0,DRX,5,21,DRX,7,5,2
502,TALON,BLEED,TALON,BLEED,Lotus,9,13,4,5,0,7,6,0,1,BLEED,Attack,0,BLEED,-4,22,TALON,5,7,-2
502,BLEED,TALON,TALON,BLEED,Bind,7,13,2,5,0,7,6,0,2,TALON,Attack,0,TALON,-6,20,BLEED,5,7,-2
502,BLEED,TALON,TALON,BLEED,Icebox,6,13,4,2,0,10,3,0,3,TALON,Attack,0,TALON,-7,19,,2,10,-8
503,T1,Paper Rex,T1,Paper Rex,Lotus,10,13,2,8,0,4,9,0,1,Paper Rex,Attack,0,Paper Rex,-3,23,T1,8,4,4
503,Paper Rex,T1,T1,Paper Rex,Bind,14,12,6,6,2,6,6,0,2,T1,Attack,1,Paper Rex,2,26,Paper Rex,6,6,0
504,Team Secret,Rex Regum Qeon,Team Secret,Rex Regum Qeon,Breeze,10,13,7,3,0,9,4,0,1,Rex Regum Qeon,Attack,0,Rex Regum Qeon,-3,23,Team Secret,3,9,-6
504,Rex Regum Qeon,Team Secret,Team Secret,Rex Regum Qeon,Split,6,13,0,6,0,6,7,0,2,Team Secret,Attack,0,Team Secret,-7,19,Rex Regum Qeon,6,6,0
504,Rex Regum Qeon,Team Secret,Team Secret,Rex Regum Qeon,Icebox,14,12,5,7,2,5,7,0,3,Team Secret,Attack,1,Rex Regum Qeon,2,26,,7,5,2
505,Global Esports,DRX,Global Esports,DRX,Ascent,8,13,5,3,0,9,4,0,1,DRX,Attack,0,DRX,-5,21,Global Esports,3,9,-6
505,DRX,Global Esports,Global Esports,DRX,Lotus,13,6,4,9,0,3,3,0,2,Global Esports,Attack,0,DRX,7,19,DRX,9,3,6
506,Gen.G,TALON,Gen.G,TALON,Lotus,13,9,4,9,0,3,6,0,1,TALON,Attack,0,Gen.G,4,22,Gen.G,9,3,6
506,TALON,Gen.G,Gen.G,TALON,Ascent,8,13,2,6,0,3,10,0,2,Gen.G,Defense,0,Gen.G,-5,21,TALON,2,10,-8
507,DetonatioN FocusMe,T1,DetonatioN FocusMe,T1,Ascent,13,10,5,8,0,3,7,0,1,T1,Defense,0,DetonatioN FocusMe,3,23,DetonatioN FocusMe,5,7,-2
507,T1,DetonatioN FocusMe,DetonatioN FocusMe,T1,Lotus,13,5,4,9,0,3,2,0,2,DetonatioN FocusMe,Attack,0,T1,8,18,T1,9,3,6
507,T1,DetonatioN FocusMe,DetonatioN FocusMe,T1,Sunset,11,13,6,5,0,7,6,0,3,DetonatioN FocusMe,Defense,0,DetonatioN FocusMe,-2,24,,6,6,0
508,Gen.G,Paper Rex,Gen.G,Paper Rex,Lotus,13,11,9,4,0,8,3,0,1,Paper Rex,Attack,0,Gen.G,2,24,Gen.G,4,8,-4
508,Paper Rex,Gen.G,Gen.G,Paper Rex,Icebox,13,11,4,9,0,3,8,0,2,Gen.G,Defense,0,Paper Rex,2,24,Paper Rex,4,8,-4
508,Paper Rex,Gen.G,Gen.G,Paper Rex,Bind,13,6,3,10,0,2,4,0,3,Gen.G,Attack,0,Paper Rex,7,19,,10,2,8
509,T1,DRX,T1,DRX,Breeze,13,9,8,5,0,7,2,0,1,DRX,Attack,0,T1,4,22,T1,5,7,-2
509,DRX,T1,T1,DRX,Split,13,5,3,10,0,2,3,0,2,T1,Attack,0,DRX,8,18,DRX,10,2,8
509,DRX,T1,T1,DRX,Bind,13,6,4,9,0,3,3,0,3,T1,Attack,0,DRX,7,19,,9,3,6
510,Team Secret,ZETA DIVISION,Team Secret,ZETA DIVISION,Icebox,13,8,6,7,0,5,3,0,1,ZETA DIVISION,Attack,0,Team Secret,5,21,Team Secret,7,5,2
510,ZETA DIVISION,Team Secret,Team Secret,ZETA DIVISION,Lotus,13,6,6,7,0,5,1,0,2,Team Secret,Attack,0,ZETA DIVISION,7,19,ZETA DIVISION,7,5,2
510,ZETA DIVISION,Team Secret,Team Secret,ZETA DIVISION,Sunset,7,13,4,3,0,9,4,0,3,Team Secret,Attack,0,Team Secret,-6,20,,3,9,-6
511,BLEED,Rex Regum Qeon,BLEED,Rex Regum Qeon,Lotus,2,13,0,2,0,10,3,0,1,Rex Regum Qeon,Attack,0,Rex Regum Qeon,-11,15,BLEED,2,10,-8
511,Rex Regum Qeon,BLEED,BLEED,Rex Regum Qeon,Icebox,13,5,5,8,0,4,1,0,2,BLEED,Attack,0,Rex Regum Qeon,8,18,Rex Regum Qeon,8,4,4
512,DetonatioN FocusMe,Gen.G,DetonatioN FocusMe,Gen.G,Split,8,13,6,2,0,7,6,0,1,Gen.G,Defense,0,Gen.G,-5,21,DetonatioN FocusMe,6,6,0
512,Gen.G,DetonatioN FocusMe,DetonatioN FocusMe,Gen.G,Lotus,13,7,7,6,0,6,1,0,2,DetonatioN FocusMe,Attack,0,Gen.G,6,20,Gen.G,6,6,0
513,TALON,Global Esports,TALON,Global Esports,Icebox,4,13,1,3,0,9,4,0,1,Global Esports,Attack,0,Global Esports,-9,17,TALON,3,9,-6
513,Global Esports,TALON,TALON,Global Esports,Breeze,12,14,6,6,0,6,6,2,2,TALON,Attack,1,TALON,-2,26,Global Esports,6,6,0
513,Global Esports,TALON,TALON,Global Esports,Lotus,6,13,1,5,0,7,6,0,3,TALON,Attack,0,TALON,-7,19,,5,7,-2
514,Rex Regum Qeon,T1,Rex Regum Qeon,T1,Ascent,6,13,6,0,0,7,6,0,1,T1,Defense,0,T1,-7,19,Rex Regum Qeon,6,6,0
514,T1,Rex Regum Qeon,Rex Regum Qeon,T1,Lotus,13,8,7,6,0,6,2,0,2,Rex Regum Qeon,Attack,0,T1,5,21,T1,6,6,0
515,BLEED,ZETA DIVISION,BLEED,ZETA DIVISION,Sunset,9,13,3,6,0,6,7,0,1,ZETA DIVISION,Attack,0,ZETA DIVISION,-4,22,BLEED,6,6,0
515,ZETA DIVISION,BLEED,BLEED,ZETA DIVISION,Ascent,9,13,5,4,0,6,7,0,2,BLEED,Defense,0,BLEED,-4,22,ZETA DIVISION,5,7,-2
515,ZETA DIVISION,BLEED,BLEED,ZETA DIVISION,Lotus,13,8,4,9,0,3,5,0,3,BLEED,Attack,0,ZETA DIVISION,5,21,,9,3,6
516,DRX,Gen.G,DRX,Gen.G,Bind,13,10,8,5,0,6,4,0,1,Gen.G,Defense,0,DRX,3,23,DRX,8,4,4
516,Gen.G,DRX,DRX,Gen.G,Ascent,13,9,8,5,0,7,2,0,2,DRX,Attack,0,Gen.G,4,22,Gen.G,5,7,-2
516,Gen.G,DRX,DRX,Gen.G,Split,7,13,6,1,0,7,6,0,3,DRX,Defense,0,DRX,-6,20,,6,6,0
517,BLEED,DetonatioN FocusMe,BLEED,DetonatioN FocusMe,Lotus,9,13,2,7,0,5,8,0,1,DetonatioN FocusMe,Attack,0,DetonatioN FocusMe,-4,22,BLEED,7,5,2
517,DetonatioN FocusMe,BLEED,BLEED,DetonatioN FocusMe,Split,7,13,5,2,0,10,3,0,2,BLEED,Attack,0,BLEED,-6,20,DetonatioN FocusMe,2,10,-8
517,DetonatioN FocusMe,BLEED,BLEED,DetonatioN FocusMe,Ascent,4,13,2,2,0,3,10,0,3,BLEED,Defense,0,BLEED,-9,17,,2,10,-8
518,Rex Regum Qeon,Global Esports,Rex Regum Qeon,Global Esports,Lotus,10,13,5,5,0,7,6,0,1,Global Esports,Attack,0,Global Esports,-3,23,Rex Regum Qeon,5,7,-2
518,Global Esports,Rex Regum Qeon,Rex Regum Qeon,Global Esports,Icebox,13,4,8,5,0,0,4,0,2,Rex Regum Qeon,Defense,0,Global Esports,9,17,Global Esports,8,4,4
519,Team Secret,Paper Rex,Team Secret,Paper Rex,Icebox,13,9,5,8,0,4,5,0,1,Paper Rex,Attack,0,Team Secret,4,22,Team Secret,8,4,4
519,Paper Rex,Team Secret,Team Secret,Paper Rex,Sunset,8,13,3,5,0,7,6,0,2,Team Secret,Attack,0,Team Secret,-5,21,Paper Rex,5,7,-2
520,T1,TALON,T1,TALON,Lotus,11,13,6,5,0,7,6,0,1,TALON,Attack,0,TALON,-2,24,T1,5,7,-2
520,TALON,T1,T1,TALON,Bind,13,10,6,7,0,5,5,0,2,T1,Attack,0,TALON,3,23,TALON,7,5,2
521,ZETA DIVISION,Gen.G,ZETA DIVISION,Gen.G,Split,8,13,5,3,0,6,7,0,1,Gen.G,Defense,0,Gen.G,-5,21,ZETA DIVISION,5,7,-2
521,Gen.G,ZETA DIVISION,ZETA DIVISION,Gen.G,Ascent,14,12,7,5,2,7,5,0,2,ZETA DIVISION,Defense,1,Gen.G,2,26,Gen.G,7,5,2
522,DetonatioN FocusMe,Team Secret,DetonatioN FocusMe,Team Secret,Lotus,4,13,2,2,0,10,3,0,1,Team Secret,Attack,0,Team Secret,-9,17,DetonatioN FocusMe,2,10,-8
522,Team Secret,DetonatioN FocusMe,DetonatioN FocusMe,Team Secret,Breeze,9,13,1,8,0,4,9,0,2,DetonatioN FocusMe,Attack,0,DetonatioN FocusMe,-4,22,Team Secret,8,4,4
522,Team Secret,DetonatioN FocusMe,DetonatioN FocusMe,Team Secret,Sunset,13,2,1,12,0,0,2,0,3,DetonatioN FocusMe,Attack,0,Team Secret,11,15,,12,0,12
523,Paper Rex,Global Esports,Paper Rex,Global Esports,Sunset,13,4,10,3,0,2,2,0,1,Global Esports,Defense,0,Paper Rex,9,17,Paper Rex,10,2,8
523,Global Esports,Paper Rex,Paper Rex,Global Esports,Icebox,7,13,2,5,0,7,6,0,2,Paper Rex,Attack,0,Paper Rex,-6,20,Global Esports,5,7,-2
524,BLEED,Paper Rex,BLEED,Paper Rex,Ascent,5,13,3,2,0,4,9,0,1,Paper Rex,Defense,0,Paper Rex,-8,18,BLEED,3,9,-6
524,Paper Rex,BLEED,BLEED,Paper Rex,Bind,13,6,6,7,0,5,1,0,2,BLEED,Attack,0,Paper Rex,7,19,Paper Rex,7,5,2
525,Global Esports,DetonatioN FocusMe,Global Esports,DetonatioN FocusMe,Split,10,13,6,4,0,7,6,0,1,DetonatioN FocusMe,Defense,0,DetonatioN FocusMe,-3,23,Global Esports,6,6,0
525,DetonatioN FocusMe,Global Esports,Global Esports,DetonatioN FocusMe,Lotus,5,13,4,1,0,11,2,0,2,Global Esports,Attack,0,Global Esports,-8,18,DetonatioN FocusMe,1,11,-10
525,DetonatioN FocusMe,Global Esports,Global Esports,DetonatioN FocusMe,Ascent,11,13,6,5,0,7,6,0,3,Global Esports,Defense,0,Global Esports,-2,24,,6,6,0
526,ZETA DIVISION,T1,ZETA DIVISION,T1,Bind,13,11,7,6,0,6,5,0,1,T1,Attack,0,ZETA DIVISION,2,24,ZETA DIVISION,6,6,0
526,T1,ZETA DIVISION,ZETA DIVISION,T1,Lotus,13,9,8,5,0,5,4,0,2,ZETA DIVISION,Defense,0,T1,4,22,T1,8,4,4
526,T1,ZETA DIVISION,ZETA DIVISION,T1,Sunset,13,10,6,7,0,4,6,0,3,ZETA DIVISION,Defense,0,T1,3,23,,6,6,0
527,Team Secret,TALON,Team Secret,TALON,Sunset,13,11,3,10,0,2,9,0,1,TALON,Defense,0,Team Secret,2,24,Team Secret,3,9,-6
527,TALON,Team Secret,Team Secret,TALON,Lotus,13,11,6,7,0,5,6,0,2,Team Secret,Attack,0,TALON,2,24,TALON,7,5,2
527,TALON,Team Secret,Team Secret,TALON,Breeze,13,10,8,5,0,7,3,0,3,Team Secret,Attack,0,TALON,3,23,,5,7,-2
528,DRX,BLEED,DRX,BLEED,Bind,13,9,6,7,0,5,4,0,1,BLEED,Attack,0,DRX,4,22,DRX,7,5,2
528,BLEED,DRX,DRX,BLEED,Breeze,4,13,2,2,0,10,3,0,2,DRX,Attack,0,DRX,-9,17,BLEED,2,10,-8
529,Rex Regum Qeon,Gen.G,Rex Regum Qeon,Gen.G,Breeze,3,13,1,2,0,2,11,0,1,Gen.G,Defense,0,Gen.G,-10,16,Rex Regum Qeon,1,11,-10
529,Gen.G,Rex Regum Qeon,Rex Regum Qeon,Gen.G,Ascent,11,13,5,6,0,6,7,0,2,Rex Regum Qeon,Attack,0,Rex Regum Qeon,-2,24,Gen.G,6,6,0
529,Gen.G,Rex Regum Qeon,Rex Regum Qeon,Gen.G,Split,10,13,5,5,0,6,7,0,3,Rex Regum Qeon,Defense,0,Rex Regum Qeon,-3,23,,5,7,-2
530,T1,Team Secret,T1,Team Secret,Lotus,13,7,6,7,0,5,2,0,1,Team Secret,Attack,0,T1,6,20,T1,7,5,2
530,Team Secret,T1,T1,Team Secret,Sunset,11,13,2,9,0,3,10,0,2,T1,Attack,0,T1,-2,24,Team Secret,9,3,6
531,TALON,Paper Rex,TALON,Paper Rex,Lotus,0,13,0,0,0,12,1,0,1,Paper Rex,Attack,0,Paper Rex,-13,13,TALON,0,12,-12
531,Paper Rex,TALON,TALON,Paper Rex,Sunset,13,9,3,10,0,2,7,0,2,TALON,Attack,0,Paper Rex,4,22,Paper Rex,10,2,8
531,Paper Rex,TALON,TALON,Paper Rex,Bind,7,13,4,3,0,9,4,0,3,TALON,Attack,0,TALON,-6,20,,3,9,-6
532,Gen.G,T1,Gen.G,T1,Ascent,9,13,3,6,0,4,9,0,1,T1,Defense,0,T1,-4,22,Gen.G,3,9,-6
532,T1,Gen.G,Gen.G,T1,Sunset,8,13,6,2,0,7,6,0,2,Gen.G,Defense,0,Gen.G,-5,21,T1,6,6,0
532,T1,Gen.G,Gen.G,T1,Breeze,13,7,8,5,0,3,4,0,3,Gen.G,Defense,0,T1,6,20,,8,4,4
533,Paper Rex,DRX,Paper Rex,DRX,Lotus,13,6,5,8,0,4,2,0,1,DRX,Attack,0,Paper Rex,7,19,Paper Rex,8,4,4
533,DRX,Paper Rex,Paper Rex,DRX,Ascent,13,10,5,8,0,3,7,0,2,Paper Rex,Defense,0,DRX,3,23,DRX,5,7,-2
533,DRX,Paper Rex,Paper Rex,DRX,Bind,6,13,2,4,0,8,5,0,3,Paper Rex,Attack,0,Paper Rex,-7,19,,4,8,-4
534,T1,Paper Rex,T1,Paper Rex,Lotus,3,13,2,1,0,11,2,0,1,Paper Rex,Attack,0,Paper Rex,-10,16,T1,1,11,-10
534,Paper Rex,T1,T1,Paper Rex,Sunset,13,5,3,10,0,2,3,0,2,T1,Attack,0,Paper Rex,8,18,Paper Rex,10,2,8
535,DRX,Gen.G,DRX,Gen.G,Bind,13,8,6,7,0,2,6,0,1,Gen.G,Defense,0,DRX,5,21,DRX,6,6,0
535,Gen.G,DRX,DRX,Gen.G,Sunset,13,11,9,4,0,8,3,0,2,DRX,Attack,0,Gen.G,2,24,Gen.G,4,8,-4
535,Gen.G,DRX,DRX,Gen.G,Ascent,13,8,8,5,0,4,4,0,3,DRX,Defense,0,Gen.G,5,21,,8,4,4
536,T1,Gen.G,T1,Gen.G,Lotus,2,13,2,0,0,3,10,0,1,Gen.G,Defense,0,Gen.G,-11,15,T1,2,10,-8
536,Gen.G,T1,T1,Gen.G,Icebox,13,11,5,8,0,4,7,0,2,T1,Attack,0,Gen.G,2,24,Gen.G,8,4,4
536,T1,Gen.G,T1,Gen.G,Bind,9,13,5,4,0,6,7,0,3,Gen.G,Defense,0,Gen.G,-4,22,T1,5,7,-2
537,Paper Rex,Gen.G,Paper Rex,Gen.G,Lotus,9,13,6,3,0,7,6,0,1,Gen.G,Defense,0,Gen.G,-4,22,Paper Rex,6,6,0
537,Gen.G,Paper Rex,Paper Rex,Gen.G,Sunset,9,13,5,4,0,6,7,0,2,Paper Rex,Defense,0,Paper Rex,-4,22,Gen.G,5,7,-2
537,Paper Rex,Gen.G,Paper Rex,Gen.G,Icebox,13,11,7,6,0,6,5,0,3,Gen.G,Defense,0,Paper Rex,2,24,Paper Rex,7,5,2
537,Gen.G,Paper Rex,Paper Rex,Gen.G,Bind,13,9,7,6,0,6,3,0,4,Paper Rex,Attack,0,Gen.G,4,22,Gen.G,6,6,0
537,Paper Rex,Gen.G,Paper Rex,Gen.G,Split,13,8,5,8,0,1,7,0,5,Gen.G,Defense,0,Paper Rex,5,21,,5,7,-2
538,Cloud9,LEVIATÁN,Cloud9,LEVIATÁN,Icebox,7,13,4,3,0,9,4,0,1,LEVIATÁN,Attack,0,LEVIATÁN,-6,20,Cloud9,3,9,-6
538,LEVIATÁN,Cloud9,Cloud9,LEVIATÁN,Sunset,7,13,6,1,0,7,6,0,2,Cloud9,Defense,0,Cloud9,-6,20,LEVIATÁN,6,6,0
538,LEVIATÁN,Cloud9,Cloud9,LEVIATÁN,Ascent,16,18,7,5,4,7,5,6,3,Cloud9,Defense,1,Cloud9,-2,34,,7,5,2
539,NRG Esports,LOUD,NRG Esports,LOUD,Breeze,13,10,8,5,0,7,3,0,1,LOUD,Attack,0,NRG Esports,3,23,NRG Esports,5,7,-2
539,LOUD,NRG Esports,NRG Esports,LOUD,Sunset,2,13,0,2,0,10,3,0,2,NRG Esports,Attack,0,NRG Esports,-11,15,LOUD,2,10,-8
540,G2 Esports,Evil Geniuses,G2 Esports,Evil Geniuses,Lotus,13,8,7,6,0,6,2,0,1,Evil Geniuses,Attack,0,G2 Esports,5,21,G2 Esports,6,6,0
540,Evil Geniuses,G2 Esports,G2 Esports,Evil Geniuses,Icebox,3,13,3,0,0,4,9,0,2,G2 Esports,Defense,0,G2 Esports,-10,16,Evil Geniuses,3,9,-6
541,100 Thieves,Sentinels,100 Thieves,Sentinels,Icebox,10,13,7,3,0,8,5,0,1,Sentinels,Defense,0,Sentinels,-3,23,100 Thieves,7,5,2
541,Sentinels,100 Thieves,100 Thieves,Sentinels,Split,13,6,7,6,0,1,5,0,2,100 Thieves,Defense,0,Sentinels,7,19,Sentinels,7,5,2
542,FURIA,KRÜ Esports,FURIA,KRÜ Esports,Lotus,7,13,5,2,0,10,3,0,1,KRÜ Esports,Attack,0,KRÜ Esports,-6,20,FURIA,2,10,-8
542,KRÜ Esports,FURIA,FURIA,KRÜ Esports,Icebox,11,13,7,4,0,8,5,0,2,FURIA,Attack,0,FURIA,-2,24,KRÜ Esports,4,8,-4
542,KRÜ Esports,FURIA,FURIA,KRÜ Esports,Breeze,13,7,6,7,0,5,2,0,3,FURIA,Attack,0,KRÜ Esports,6,20,,7,5,2
543,100 Thieves,G2 Esports,100 Thieves,G2 Esports,Bind,13,9,8,5,0,5,4,0,1,G2 Esports,Defense,0,100 Thieves,4,22,100 Thieves,8,4,4
543,G2 Esports,100 Thieves,100 Thieves,G2 Esports,Split,8,13,4,4,0,5,8,0,2,100 Thieves,Defense,0,100 Thieves,-5,21,G2 Esports,4,8,-4
544,Sentinels,LEVIATÁN,Sentinels,LEVIATÁN,Lotus,17,19,9,3,5,9,3,7,1,LEVIATÁN,Attack,1,LEVIATÁN,-2,36,Sentinels,3,9,-6
544,LEVIATÁN,Sentinels,Sentinels,LEVIATÁN,Icebox,13,11,7,6,0,6,5,0,2,Sentinels,Defense,0,LEVIATÁN,2,24,LEVIATÁN,7,5,2
545,KRÜ Esports,MIBR,KRÜ Esports,MIBR,Icebox,13,6,7,6,0,1,5,0,1,MIBR,Defense,0,KRÜ Esports,7,19,KRÜ Esports,7,5,2
545,MIBR,KRÜ Esports,KRÜ Esports,MIBR,Sunset,8,13,5,3,0,6,7,0,2,KRÜ Esports,Defense,0,KRÜ Esports,-5,21,MIBR,5,7,-2
546,FURIA,NRG Esports,FURIA,NRG Esports,Split,2,13,0,2,0,10,3,0,1,NRG Esports,Attack,0,NRG Esports,-11,15,FURIA,2,10,-8
546,NRG Esports,FURIA,FURIA,NRG Esports,Breeze,13,8,7,6,0,6,2,0,2,FURIA,Attack,0,NRG Esports,5,21,NRG Esports,6,6,0
547,Cloud9,Evil Geniuses,Cloud9,Evil Geniuses,Lotus,9,13,2,7,0,5,8,0,1,Evil Geniuses,Attack,0,Evil Geniuses,-4,22,Cloud9,7,5,2
547,Evil Geniuses,Cloud9,Cloud9,Evil Geniuses,Sunset,8,13,4,4,0,8,5,0,2,Cloud9,Attack,0,Cloud9,-5,21,Evil Geniuses,4,8,-4
547,Evil Geniuses,Cloud9,Cloud9,Evil Geniuses,Split,4,13,2,2,0,3,10,0,3,Cloud9,Defense,0,Cloud9,-9,17,,2,10,-8
548,Sentinels,MIBR,Sentinels,MIBR,Lotus,13,3,4,9,0,3,0,0,1,MIBR,Attack,0,Sentinels,10,16,Sentinels,9,3,6
548,MIBR,Sentinels,Sentinels,MIBR,Bind,7,13,4,3,0,9,4,0,2,Sentinels,Attack,0,Sentinels,-6,20,MIBR,3,9,-6
549,Cloud9,LOUD,Cloud9,LOUD,Bind,11,13,5,6,0,6,7,0,1,LOUD,Attack,0,LOUD,-2,24,Cloud9,6,6,0
549,LOUD,Cloud9,Cloud9,LOUD,Icebox,4,13,1,3,0,9,4,0,2,Cloud9,Attack,0,Cloud9,-9,17,LOUD,3,9,-6
549,LOUD,Cloud9,Cloud9,LOUD,Lotus,9,13,3,6,0,6,7,0,3,Cloud9,Attack,0,Cloud9,-4,22,,6,6,0
550,Evil Geniuses,KRÜ Esports,Evil Geniuses,KRÜ Esports,Lotus,5,13,3,2,0,10,3,0,1,KRÜ Esports,Attack,0,KRÜ Esports,-8,18,Evil Geniuses,2,10,-8
550,KRÜ Esports,Evil Geniuses,Evil Geniuses,KRÜ Esports,Breeze,13,9,5,8,0,4,5,0,2,Evil Geniuses,Attack,0,KRÜ Esports,4,22,KRÜ Esports,8,4,4
551,NRG Esports,LEVIATÁN,NRG Esports,LEVIATÁN,Sunset,4,13,2,2,0,3,10,0,1,LEVIATÁN,Defense,0,LEVIATÁN,-9,17,NRG Esports,2,10,-8
551,LEVIATÁN,NRG Esports,NRG Esports,LEVIATÁN,Bind,13,4,2,11,0,1,3,0,2,NRG Esports,Attack,0,LEVIATÁN,9,17,LEVIATÁN,11,1,10
552,FURIA,G2 Esports,FURIA,G2 Esports,Lotus,3,13,0,3,0,9,4,0,1,G2 Esports,Attack,0,G2 Esports,-10,16,FURIA,3,9,-6
552,G2 Esports,FURIA,FURIA,G2 Esports,Icebox,13,3,4,9,0,3,0,0,2,FURIA,Attack,0,G2 Esports,10,16,G2 Esports,9,3,6
553,100 Thieves,Cloud9,100 Thieves,Cloud9,Bind,13,7,5,8,0,4,3,0,1,Cloud9,Attack,0,100 Thieves,6,20,100 Thieves,8,4,4
553,Cloud9,100 Thieves,100 Thieves,Cloud9,Ascent,6,13,1,5,0,2,11,0,2,100 Thieves,Defense,0,100 Thieves,-7,19,Cloud9,1,11,-10
554,Sentinels,Evil Geniuses,Sentinels,Evil Geniuses,Lotus,13,10,10,3,0,9,1,0,1,Evil Geniuses,Attack,0,Sentinels,3,23,Sentinels,3,9,-6
554,Evil Geniuses,Sentinels,Sentinels,Evil Geniuses,Bind,13,11,11,2,0,10,1,0,2,Sentinels,Attack,0,Evil Geniuses,2,24,Evil Geniuses,2,10,-8
554,Evil Geniuses,Sentinels,Sentinels,Evil Geniuses,Sunset,13,10,7,6,0,6,4,0,3,Sentinels,Attack,0,Evil Geniuses,3,23,,6,6,0
555,MIBR,NRG Esports,MIBR,NRG Esports,Split,9,13,4,5,0,7,6,0,1,NRG Esports,Attack,0,NRG Esports,-4,22,MIBR,5,7,-2
555,NRG Esports,MIBR,MIBR,NRG Esports,Breeze,13,3,4,9,0,3,0,0,2,MIBR,Attack,0,NRG Esports,10,16,NRG Esports,9,3,6
556,LEVIATÁN,G2 Esports,LEVIATÁN,G2 Esports,Breeze,13,6,3,10,0,2,4,0,1,G2 Esports,Attack,0,LEVIATÁN,7,19,LEVIATÁN,10,2,8
556,G2 Esports,LEVIATÁN,LEVIATÁN,G2 Esports,Icebox,13,8,7,6,0,6,2,0,2,LEVIATÁN,Attack,0,G2 Esports,5,21,G2 Esports,6,6,0
556,G2 Esports,LEVIATÁN,LEVIATÁN,G2 Esports,Lotus,9,13,4,5,0,7,6,0,3,LEVIATÁN,Attack,0,LEVIATÁN,-4,22,,5,7,-2
557,KRÜ Esports,LOUD,KRÜ Esports,LOUD,Split,13,8,8,5,0,7,1,0,1,LOUD,Attack,0,KRÜ Esports,5,21,KRÜ Esports,5,7,-2
557,LOUD,KRÜ Esports,KRÜ Esports,LOUD,Ascent,8,13,5,3,0,6,7,0,2,KRÜ Esports,Defense,0,KRÜ Esports,-5,21,LOUD,5,7,-2
558,G2 Esports,MIBR,G2 Esports,MIBR,Icebox,13,9,6,7,0,5,4,0,1,MIBR,Attack,0,G2 Esports,4,22,G2 Esports,7,5,2
558,MIBR,G2 Esports,G2 Esports,MIBR,Bind,3,13,2,1,0,11,2,0,2,G2 Esports,Attack,0,G2 Esports,-10,16,MIBR,1,11,-10
559,Sentinels,LOUD,Sentinels,LOUD,Lotus,7,13,5,2,0,10,3,0,1,LOUD,Attack,0,LOUD,-6,20,Sentinels,2,10,-8
559,LOUD,Sentinels,Sentinels,LOUD,Icebox,13,8,7,6,0,3,5,0,2,Sentinels,Defense,0,LOUD,5,21,LOUD,7,5,2
560,FURIA,Cloud9,FURIA,Cloud9,Ascent,13,2,12,1,0,2,0,0,1,Cloud9,Defense,0,FURIA,11,15,FURIA,12,0,12
560,Cloud9,FURIA,FURIA,Cloud9,Lotus,13,3,4,9,0,3,0,0,2,FURIA,Attack,0,Cloud9,10,16,Cloud9,9,3,6
560,Cloud9,FURIA,FURIA,Cloud9,Bind,13,8,5,8,0,4,4,0,3,FURIA,Attack,0,Cloud9,5,21,,8,4,4
561,NRG Esports,Evil Geniuses,NRG Esports,Evil Geniuses,Ascent,6,13,2,4,0,3,10,0,1,Evil Geniuses,Defense,0,Evil Geniuses,-7,19,NRG Esports,2,10,-8
561,Evil Geniuses,NRG Esports,NRG Esports,Evil Geniuses,Lotus,14,16,6,6,2,6,6,4,2,NRG Esports,Attack,1,NRG Esports,-2,30,Evil Geniuses,6,6,0
561,Evil Geniuses,NRG Esports,NRG Esports,Evil Geniuses,Sunset,13,11,7,6,0,6,5,0,3,NRG Esports,Defense,0,Evil Geniuses,2,24,,7,5,2
562,100 Thieves,KRÜ Esports,100 Thieves,KRÜ Esports,Sunset,7,13,2,5,0,7,6,0,1,KRÜ Esports,Attack,0,KRÜ Esports,-6,20,100 Thieves,5,7,-2
562,KRÜ Esports,100 Thieves,100 Thieves,KRÜ Esports,Breeze,11,13,4,7,0,5,8,0,2,100 Thieves,Defense,0,100 Thieves,-2,24,KRÜ Esports,4,8,-4
562,KRÜ Esports,100 Thieves,100 Thieves,KRÜ Esports,Split,13,8,6,7,0,2,6,0,3,100 Thieves,Defense,0,KRÜ Esports,5,21,,6,6,0
563,Sentinels,FURIA,Sentinels,FURIA,Split,13,5,5,8,0,4,1,0,1,FURIA,Attack,0,Sentinels,8,18,Sentinels,8,4,4
563,FURIA,Sentinels,Sentinels,FURIA,Icebox,9,13,4,5,0,5,8,0,2,Sentinels,Defense,0,Sentinels,-4,22,FURIA,4,8,-4
564,NRG Esports,100 Thieves,NRG Esports,100 Thieves,Split,8,13,7,1,0,8,5,0,1,100 Thieves,Defense,0,100 Thieves,-5,21,NRG Esports,7,5,2
564,100 Thieves,NRG Esports,NRG Esports,100 Thieves,Bind,13,7,5,8,0,4,3,0,2,NRG Esports,Attack,0,100 Thieves,6,20,100 Thieves,8,4,4
565,KRÜ Esports,LEVIATÁN,KRÜ Esports,LEVIATÁN,Ascent,4,13,3,1,0,4,9,0,1,LEVIATÁN,Defense,0,LEVIATÁN,-9,17,KRÜ Esports,3,9,-6
565,LEVIATÁN,KRÜ Esports,KRÜ Esports,LEVIATÁN,Breeze,12,14,4,8,0,4,8,2,2,KRÜ Esports,Attack,1,KRÜ Esports,-2,26,LEVIATÁN,8,4,4
565,LEVIATÁN,KRÜ Esports,KRÜ Esports,LEVIATÁN,Lotus,13,10,7,6,0,6,4,0,3,KRÜ Esports,Attack,0,LEVIATÁN,3,23,,6,6,0
566,Cloud9,MIBR,Cloud9,MIBR,Icebox,14,12,3,9,2,3,9,0,1,MIBR,Attack,1,Cloud9,2,26,Cloud9,9,3,6
566,MIBR,Cloud9,Cloud9,MIBR,Sunset,9,13,5,4,0,8,5,0,2,Cloud9,Attack,0,Cloud9,-4,22,MIBR,4,8,-4
567,G2 Esports,LOUD,G2 Esports,LOUD,Bind,11,13,6,5,0,7,6,0,1,LOUD,Attack,0,LOUD,-2,24,G2 Esports,5,7,-2
567,LOUD,G2 Esports,G2 Esports,LOUD,Icebox,13,4,4,9,0,3,1,0,2,G2 Esports,Attack,0,LOUD,9,17,LOUD,9,3,6
568,Cloud9,G2 Esports,Cloud9,G2 Esports,Lotus,6,13,1,5,0,7,6,0,1,G2 Esports,Attack,0,G2 Esports,-7,19,Cloud9,5,7,-2
568,G2 Esports,Cloud9,Cloud9,G2 Esports,Ascent,15,13,7,5,3,7,5,1,2,Cloud9,Defense,1,G2 Esports,2,28,G2 Esports,7,5,2
569,100 Thieves,LOUD,100 Thieves,LOUD,Bind,13,6,5,8,0,4,2,0,1,LOUD,Attack,0,100 Thieves,7,19,100 Thieves,8,4,4
569,LOUD,100 Thieves,100 Thieves,LOUD,Icebox,4,13,2,2,0,3,10,0,2,100 Thieves,Defense,0,100 Thieves,-9,17,LOUD,2,10,-8
570,KRÜ Esports,G2 Esports,KRÜ Esports,G2 Esports,Icebox,5,13,4,1,0,5,8,0,1,G2 Esports,Defense,0,G2 Esports,-8,18,KRÜ Esports,4,8,-4
570,G2 Esports,KRÜ Esports,KRÜ Esports,G2 Esports,Ascent,13,8,6,7,0,2,6,0,2,KRÜ Esports,Defense,0,G2 Esports,5,21,G2 Esports,6,6,0
571,100 Thieves,LEVIATÁN,100 Thieves,LEVIATÁN,Bind,13,3,4,9,0,3,0,0,1,LEVIATÁN,Attack,0,100 Thieves,10,16,100 Thieves,9,3,6
571,LEVIATÁN,100 Thieves,100 Thieves,LEVIATÁN,Sunset,14,12,8,4,2,8,4,0,2,100 Thieves,Defense,1,LEVIATÁN,2,26,LEVIATÁN,8,4,4
571,LEVIATÁN,100 Thieves,100 Thieves,LEVIATÁN,Icebox,10,13,6,4,0,7,6,0,3,100 Thieves,Defense,0,100 Thieves,-3,23,,6,6,0
572,G2 Esports,100 Thieves,G2 Esports,100 Thieves,Ascent,5,13,5,0,0,6,7,0,1,100 Thieves,Defense,0,100 Thieves,-8,18,G2 Esports,5,7,-2
572,100 Thieves,G2 Esports,G2 Esports,100 Thieves,Bind,8,13,6,2,0,7,6,0,2,G2 Esports,Defense,0,G2 Esports,-5,21,100 Thieves,6,6,0
572,100 Thieves,G2 Esports,G2 Esports,100 Thieves,Split,13,11,4,9,0,3,8,0,3,G2 Esports,Defense,0,100 Thieves,2,24,,4,8,-4
573,LEVIATÁN,KRÜ Esports,LEVIATÁN,KRÜ Esports,Lotus,6,13,1,5,0,7,6,0,1,KRÜ Esports,Attack,0,KRÜ Esports,-7,19,LEVIATÁN,5,7,-2
573,KRÜ Esports,LEVIATÁN,LEVIATÁN,KRÜ Esports,Icebox,11,13,4,7,0,5,8,0,2,LEVIATÁN,Attack,0,LEVIATÁN,-2,24,KRÜ Esports,7,5,2
573,KRÜ Esports,LEVIATÁN,LEVIATÁN,KRÜ Esports,Sunset,8,13,7,1,0,8,5,0,3,LEVIATÁN,Defense,0,LEVIATÁN,-5,21,,7,5,2
574,G2 Esports,LEVIATÁN,G2 Esports,LEVIATÁN,Bind,12,14,6,6,0,6,6,2,1,LEVIATÁN,Attack,1,LEVIATÁN,-2,26,G2 Esports,6,6,0
574,LEVIATÁN,G2 Esports,G2 Esports,LEVIATÁN,Breeze,7,13,3,4,0,4,9,0,2,G2 Esports,Defense,0,G2 Esports,-6,20,LEVIATÁN,3,9,-6
574,G2 Esports,LEVIATÁN,G2 Esports,LEVIATÁN,Icebox,12,14,6,6,0,6,6,2,3,LEVIATÁN,Attack,1,LEVIATÁN,-2,26,G2 Esports,6,6,0
574,LEVIATÁN,G2 Esports,G2 Esports,LEVIATÁN,Lotus,10,13,6,4,0,8,5,0,4,G2 Esports,Attack,0,G2 Esports,-3,23,LEVIATÁN,4,8,-4
574,G2 Esports,LEVIATÁN,G2 Esports,LEVIATÁN,Ascent,13,11,5,8,0,4,7,0,5,LEVIATÁN,Defense,0,G2 Esports,2,24,,5,7,-2
575,100 Thieves,G2 Esports,100 Thieves,G2 Esports,Bind,13,9,4,9,0,1,8,0,1,G2 Esports,Defense,0,100 Thieves,4,22,100 Thieves,4,8,-4
575,G2 Esports,100 Thieves,100 Thieves,G2 Esports,Breeze,7,13,6,1,0,7,6,0,2,100 Thieves,Defense,0,100 Thieves,-6,20,G2 Esports,6,6,0
575,100 Thieves,G2 Esports,100 Thieves,G2 Esports,Sunset,13,8,5,8,0,4,4,0,3,G2 Esports,Attack,0,100 Thieves,5,21,100 Thieves,8,4,4
576,T1,G2 Esports,T1,G2 Esports,Breeze,8,13,5,3,0,6,7,0,1,G2 Esports,Defense,0,G2 Esports,-5,21,T1,5,7,-2
576,G2 Esports,T1,T1,G2 Esports,Icebox,1,13,0,1,0,11,2,0,2,T1,Attack,0,T1,-12,14,G2 Esports,1,11,-10
576,G2 Esports,T1,T1,G2 Esports,Lotus,14,12,3,9,2,3,9,0,3,T1,Defense,1,G2 Esports,2,26,,3,9,-6
577,FUT Esports,FunPlus Phoenix,FUT Esports,FunPlus Phoenix,Sunset,7,13,4,3,0,9,4,0,1,FunPlus Phoenix,Attack,0,FunPlus Phoenix,-6,20,FUT Esports,3,9,-6
577,FunPlus Phoenix,FUT Esports,FUT Esports,FunPlus Phoenix,Lotus,12,14,8,4,0,8,4,2,2,FUT Esports,Attack,1,FUT Esports,-2,26,FunPlus Phoenix,4,8,-4
577,FunPlus Phoenix,FUT Esports,FUT Esports,FunPlus Phoenix,Icebox,13,10,9,4,0,8,2,0,3,FUT Esports,Attack,0,FunPlus Phoenix,3,23,,4,8,-4
578,LEVIATÁN,Gen.G,LEVIATÁN,Gen.G,Icebox,13,7,7,6,0,2,5,0,1,Gen.G,Defense,0,LEVIATÁN,6,20,LEVIATÁN,7,5,2
578,Gen.G,LEVIATÁN,LEVIATÁN,Gen.G,Lotus,13,5,6,7,0,5,0,0,2,LEVIATÁN,Attack,0,Gen.G,8,18,Gen.G,7,5,2
578,Gen.G,LEVIATÁN,LEVIATÁN,Gen.G,Breeze,13,7,8,5,0,3,4,0,3,LEVIATÁN,Defense,0,Gen.G,6,20,,8,4,4
579,Dragon Ranger Gaming,Team Heretics,Dragon Ranger Gaming,Team Heretics,Icebox,5,13,4,1,0,5,8,0,1,Team Heretics,Defense,0,Team Heretics,-8,18,Dragon Ranger Gaming,4,8,-4
579,Team Heretics,Dragon Ranger Gaming,Dragon Ranger Gaming,Team Heretics,Sunset,13,5,7,6,0,0,5,0,2,Dragon Ranger Gaming,Defense,0,Team Heretics,8,18,Team Heretics,7,5,2
580,Gen.G,FunPlus Phoenix,Gen.G,FunPlus Phoenix,Lotus,14,16,10,2,2,10,2,4,1,FunPlus Phoenix,Attack,1,FunPlus Phoenix,-2,30,Gen.G,2,10,-8
580,FunPlus Phoenix,Gen.G,Gen.G,FunPlus Phoenix,Sunset,7,13,1,6,0,6,7,0,2,Gen.G,Attack,0,Gen.G,-6,20,FunPlus Phoenix,6,6,0
580,FunPlus Phoenix,Gen.G,Gen.G,FunPlus Phoenix,Ascent,11,13,4,7,0,5,8,0,3,Gen.G,Defense,0,Gen.G,-2,24,,4,8,-4
581,Team Heretics,G2 Esports,Team Heretics,G2 Esports,Lotus,13,9,5,8,0,4,5,0,1,G2 Esports,Attack,0,Team Heretics,4,22,Team Heretics,8,4,4
581,G2 Esports,Team Heretics,Team Heretics,G2 Esports,Bind,13,6,9,4,0,3,3,0,2,Team Heretics,Defense,0,G2 Esports,7,19,G2 Esports,9,3,6
581,G2 Esports,Team Heretics,Team Heretics,G2 Esports,Split,13,8,9,4,0,5,3,0,3,Team Heretics,Defense,0,G2 Esports,5,21,,9,3,6
582,T1,LEVIATÁN,T1,LEVIATÁN,Breeze,9,13,3,6,0,4,9,0,1,LEVIATÁN,Defense,0,LEVIATÁN,-4,22,T1,3,9,-6
582,LEVIATÁN,T1,T1,LEVIATÁN,Sunset,13,7,3,10,0,2,5,0,2,T1,Attack,0,LEVIATÁN,6,20,LEVIATÁN,10,2,8
583,FUT Esports,Dragon Ranger Gaming,FUT Esports,Dragon Ranger Gaming,Bind,13,10,8,5,0,6,4,0,1,Dragon Ranger Gaming,Defense,0,FUT Esports,3,23,FUT Esports,8,4,4
583,Dragon Ranger Gaming,FUT Esports,FUT Esports,Dragon Ranger Gaming,Ascent,12,14,5,7,0,5,7,2,2,FUT Esports,Defense,1,FUT Esports,-2,26,Dragon Ranger Gaming,5,7,-2
584,Team Heretics,FunPlus Phoenix,Team Heretics,FunPlus Phoenix,Sunset,13,4,10,3,0,2,2,0,1,FunPlus Phoenix,Defense,0,Team Heretics,9,17,Team Heretics,10,2,8
584,FunPlus Phoenix,Team Heretics,Team Heretics,FunPlus Phoenix,Lotus,13,6,8,5,0,2,4,0,2,Team Heretics,Defense,0,FunPlus Phoenix,7,19,FunPlus Phoenix,8,4,4
584,FunPlus Phoenix,Team Heretics,Team Heretics,FunPlus Phoenix,Icebox,15,17,10,2,3,10,2,5,3,Team Heretics,Attack,1,Team Heretics,-2,32,,2,10,-8
585,LEVIATÁN,FUT Esports,LEVIATÁN,FUT Esports,Sunset,1,13,0,1,0,11,2,0,1,FUT Esports,Attack,0,FUT Esports,-12,14,LEVIATÁN,1,11,-10
585,FUT Esports,LEVIATÁN,LEVIATÁN,FUT Esports,Lotus,11,13,6,5,0,7,6,0,2,LEVIATÁN,Attack,0,LEVIATÁN,-2,24,FUT Esports,5,7,-2
585,FUT Esports,LEVIATÁN,LEVIATÁN,FUT Esports,Bind,13,11,6,7,0,5,6,0,3,LEVIATÁN,Defense,0,FUT Esports,2,24,,6,6,0
586,FUT Esports,100 Thieves,FUT Esports,100 Thieves,Icebox,2,13,1,1,0,2,11,0,1,100 Thieves,Defense,0,100 Thieves,-11,15,FUT Esports,1,11,-10
586,100 Thieves,FUT Esports,FUT Esports,100 Thieves,Bind,13,5,5,8,0,4,1,0,2,FUT Esports,Attack,0,100 Thieves,8,18,100 Thieves,8,4,4
587,Gen.G,FNATIC,Gen.G,FNATIC,Lotus,10,13,3,7,0,4,9,0,1,FNATIC,Defense,0,FNATIC,-3,23,Gen.G,3,9,-6
587,FNATIC,Gen.G,Gen.G,FNATIC,Bind,10,13,6,4,0,7,6,0,2,Gen.G,Defense,0,Gen.G,-3,23,FNATIC,6,6,0
587,FNATIC,Gen.G,Gen.G,FNATIC,Breeze,11,13,7,4,0,8,5,0,3,Gen.G,Defense,0,Gen.G,-2,24,,7,5,2
588,G2 Esports,Paper Rex,G2 Esports,Paper Rex,Split,7,13,6,1,0,11,2,0,1,Paper Rex,Attack,0,Paper Rex,-6,20,G2 Esports,1,11,-10
588,Paper Rex,G2 Esports,G2 Esports,Paper Rex,Lotus,10,13,4,6,0,6,7,0,2,G2 Esports,Attack,0,G2 Esports,-3,23,Paper Rex,6,6,0
588,Paper Rex,G2 Esports,G2 Esports,Paper Rex,Bind,5,13,3,2,0,10,3,0,3,G2 Esports,Attack,0,G2 Esports,-8,18,,2,10,-8
589,Team Heretics,EDward Gaming,Team Heretics,EDward Gaming,Sunset,13,6,5,8,0,4,2,0,1,EDward Gaming,Attack,0,Team Heretics,7,19,Team Heretics,8,4,4
589,EDward Gaming,Team Heretics,Team Heretics,EDward Gaming,Split,3,13,2,1,0,3,10,0,2,Team Heretics,Defense,0,Team Heretics,-10,16,EDward Gaming,2,10,-8
590,FUT Esports,FNATIC,FUT Esports,FNATIC,Split,5,13,5,0,0,6,7,0,1,FNATIC,Defense,0,FNATIC,-8,18,FUT Esports,5,7,-2
590,FNATIC,FUT Esports,FUT Esports,FNATIC,Lotus,8,13,5,3,0,9,4,0,2,FUT Esports,Attack,0,FUT Esports,-5,21,FNATIC,3,9,-6
590,FNATIC,FUT Esports,FUT Esports,FNATIC,Ascent,3,13,3,0,0,4,9,0,3,FUT Esports,Defense,0,FUT Esports,-10,16,,3,9,-6
591,EDward Gaming,Paper Rex,EDward Gaming,Paper Rex,Bind,11,13,5,6,0,6,7,0,1,Paper Rex,Attack,0,Paper Rex,-2,24,EDward Gaming,6,6,0
591,Paper Rex,EDward Gaming,EDward Gaming,Paper Rex,Sunset,13,6,5,8,0,4,2,0,2,EDward Gaming,Attack,0,Paper Rex,7,19,Paper Rex,8,4,4
592,100 Thieves,Gen.G,100 Thieves,Gen.G,Icebox,10,13,3,7,0,4,9,0,1,Gen.G,Defense,0,Gen.G,-3,23,100 Thieves,3,9,-6
592,Gen.G,100 Thieves,100 Thieves,Gen.G,Ascent,13,10,6,7,0,4,6,0,2,100 Thieves,Defense,0,Gen.G,3,23,Gen.G,6,6,0
593,Team Heretics,G2 Esports,Team Heretics,G2 Esports,Icebox,13,7,3,10,0,2,5,0,1,G2 Esports,Attack,0,Team Heretics,6,20,Team Heretics,10,2,8
593,G2 Esports,Team Heretics,Team Heretics,G2 Esports,Ascent,13,11,2,11,0,1,10,0,2,Team Heretics,Defense,0,G2 Esports,2,24,G2 Esports,2,10,-8
593,G2 Esports,Team Heretics,Team Heretics,G2 Esports,Lotus,13,4,5,8,0,4,0,0,3,Team Heretics,Attack,0,G2 Esports,9,17,,8,4,4
594,100 Thieves,Paper Rex,100 Thieves,Paper Rex,Breeze,13,5,8,5,0,1,4,0,1,Paper Rex,Defense,0,100 Thieves,8,18,100 Thieves,8,4,4
594,Paper Rex,100 Thieves,100 Thieves,Paper Rex,Sunset,13,10,8,5,0,6,4,0,2,100 Thieves,Defense,0,Paper Rex,3,23,Paper Rex,8,4,4
594,Paper Rex,100 Thieves,100 Thieves,Paper Rex,Icebox,12,14,5,7,0,5,7,2,3,100 Thieves,Defense,1,100 Thieves,-2,26,,5,7,-2
595,FUT Esports,Team Heretics,FUT Esports,Team Heretics,Bind,7,13,6,1,0,7,6,0,1,Team Heretics,Defense,0,Team Heretics,-6,20,FUT Esports,6,6,0
595,Team Heretics,FUT Esports,FUT Esports,Team Heretics,Sunset,13,4,4,9,0,3,1,0,2,FUT Esports,Attack,0,Team Heretics,9,17,Team Heretics,9,3,6
596,G2 Esports,Gen.G,G2 Esports,Gen.G,Lotus,8,13,5,3,0,6,7,0,1,Gen.G,Defense,0,Gen.G,-5,21,G2 Esports,5,7,-2
596,Gen.G,G2 Esports,G2 Esports,Gen.G,Ascent,13,10,8,5,0,6,4,0,2,G2 Esports,Defense,0,Gen.G,3,23,Gen.G,8,4,4
597,100 Thieves,Team Heretics,100 Thieves,Team Heretics,Bind,13,15,8,4,1,8,4,3,1,Team Heretics,Attack,1,Team Heretics,-2,28,100 Thieves,4,8,-4
597,Team Heretics,100 Thieves,100 Thieves,Team Heretics,Sunset,13,1,2,11,0,1,0,0,2,100 Thieves,Attack,0,Team Heretics,12,14,Team Heretics,11,1,10
598,G2 Esports,Team Heretics,G2 Esports,Team Heretics,Bind,2,13,0,2,0,10,3,0,1,Team Heretics,Attack,0,Team Heretics,-11,15,G2 Esports,2,10,-8
598,Team Heretics,G2 Esports,G2 Esports,Team Heretics,Icebox,13,6,5,8,0,4,2,0,2,G2 Esports,Attack,0,Team Heretics,7,19,Team Heretics,8,4,4
598,G2 Esports,Team Heretics,G2 Esports,Team Heretics,Lotus,8,13,5,3,0,9,4,0,3,Team Heretics,Attack,0,Team Heretics,-5,21,G2 Esports,3,9,-6
599,Gen.G,Team Heretics,Gen.G,Team Heretics,Breeze,13,6,3,10,0,2,4,0,1,Team Heretics,Attack,0,Gen.G,7,19,Gen.G,10,2,8
599,Team Heretics,Gen.G,Gen.G,Team Heretics,Icebox,13,9,5,8,0,2,7,0,2,Gen.G,Defense,0,Team Heretics,4,22,Team Heretics,5,7,-2
599,Gen.G,Team Heretics,Gen.G,Team Heretics,Ascent,9,13,6,3,0,7,6,0,3,Team Heretics,Defense,0,Team Heretics,-4,22,Gen.G,6,6,0
599,Team Heretics,Gen.G,Gen.G,Team Heretics,Lotus,4,13,3,1,0,4,9,0,4,Gen.G,Defense,0,Gen.G,-9,17,Team Heretics,3,9,-6
599,Gen.G,Team Heretics,Gen.G,Team Heretics,Split,13,3,9,4,0,0,3,0,5,Team Heretics,Defense,0,Gen.G,10,16,,9,3,6
600,DRX,ZETA DIVISION,DRX,ZETA DIVISION,Icebox,13,0,12,1,0,0,0,0,1,ZETA DIVISION,Defense,0,DRX,13,13,DRX,12,0,12
600,ZETA DIVISION,DRX,DRX,ZETA DIVISION,Sunset,13,11,5,8,0,4,7,0,2,DRX,Attack,0,ZETA DIVISION,2,24,ZETA DIVISION,8,4,4
600,ZETA DIVISION,DRX,DRX,ZETA DIVISION,Breeze,4,13,2,2,0,10,3,0,3,DRX,Attack,0,DRX,-9,17,,2,10,-8
601,BLEED,Team Secret,BLEED,Team Secret,Ascent,13,10,2,11,0,0,10,0,1,Team Secret,Defense,0,BLEED,3,23,BLEED,2,10,-8
601,Team Secret,BLEED,BLEED,Team Secret,Sunset,13,8,8,5,0,7,1,0,2,BLEED,Attack,0,Team Secret,5,21,Team Secret,5,7,-2
601,Team Secret,BLEED,BLEED,Team Secret,Split,13,8,5,8,0,4,4,0,3,BLEED,Attack,0,Team Secret,5,21,,8,4,4
602,T1,Gen.G,T1,Gen.G,Split,13,15,7,5,1,7,5,3,1,Gen.G,Defense,1,Gen.G,-2,28,T1,7,5,2
602,Gen.G,T1,T1,Gen.G,Lotus,5,13,3,2,0,4,9,0,2,T1,Defense,0,T1,-8,18,Gen.G,3,9,-6
602,Gen.G,T1,T1,Gen.G,Sunset,13,9,7,6,0,4,5,0,3,T1,Defense,0,Gen.G,4,22,,7,5,2
603,TALON,Paper Rex,TALON,Paper Rex,Icebox,4,13,1,3,0,9,4,0,1,Paper Rex,Attack,0,Paper Rex,-9,17,TALON,3,9,-6
603,Paper Rex,TALON,TALON,Paper Rex,Sunset,13,7,9,4,0,4,3,0,2,TALON,Defense,0,Paper Rex,6,20,Paper Rex,9,3,6
604,Rex Regum Qeon,DetonatioN FocusMe,Rex Regum Qeon,DetonatioN FocusMe,Icebox,15,13,8,4,3,8,4,1,1,DetonatioN FocusMe,Attack,1,Rex Regum Qeon,2,28,Rex Regum Qeon,4,8,-4
604,DetonatioN FocusMe,Rex Regum Qeon,Rex Regum Qeon,DetonatioN FocusMe,Ascent,9,13,3,6,0,6,7,0,2,Rex Regum Qeon,Attack,0,Rex Regum Qeon,-4,22,DetonatioN FocusMe,6,6,0
605,Team Secret,Global Esports,Team Secret,Global Esports,Sunset,13,8,2,11,0,1,7,0,1,Global Esports,Attack,0,Team Secret,5,21,Team Secret,11,1,10
605,Global Esports,Team Secret,Team Secret,Global Esports,Ascent,10,13,7,3,0,8,5,0,2,Team Secret,Defense,0,Team Secret,-3,23,Global Esports,7,5,2
606,TALON,Rex Regum Qeon,TALON,Rex Regum Qeon,Lotus,15,13,6,6,3,6,6,1,1,Rex Regum Qeon,Attack,1,TALON,2,28,TALON,6,6,0
606,Rex Regum Qeon,TALON,TALON,Rex Regum Qeon,Ascent,13,10,7,6,0,5,5,0,2,TALON,Defense,0,Rex Regum Qeon,3,23,Rex Regum Qeon,7,5,2
606,Rex Regum Qeon,TALON,TALON,Rex Regum Qeon,Icebox,10,13,8,2,0,10,3,0,3,TALON,Attack,0,TALON,-3,23,,2,10,-8
607,Paper Rex,DRX,Paper Rex,DRX,Split,13,4,9,4,0,1,3,0,1,DRX,Defense,0,Paper Rex,9,17,Paper Rex,9,3,6
607,DRX,Paper Rex,Paper Rex,DRX,Haven,13,8,8,5,0,7,1,0,2,Paper Rex,Attack,0,DRX,5,21,DRX,5,7,-2
607,DRX,Paper Rex,Paper Rex,DRX,Icebox,5,13,3,2,0,10,3,0,3,Paper Rex,Attack,0,Paper Rex,-8,18,,2,10,-8
608,Global Esports,BLEED,Global Esports,BLEED,Lotus,13,6,9,4,0,3,3,0,1,BLEED,Defense,0,Global Esports,7,19,Global Esports,9,3,6
608,BLEED,Global Esports,Global Esports,BLEED,Sunset,6,13,5,1,0,6,7,0,2,Global Esports,Defense,0,Global Esports,-7,19,BLEED,5,7,-2
609,DetonatioN FocusMe,ZETA DIVISION,DetonatioN FocusMe,ZETA DIVISION,Haven,7,13,3,4,0,8,5,0,1,ZETA DIVISION,Attack,0,ZETA DIVISION,-6,20,DetonatioN FocusMe,4,8,-4
609,ZETA DIVISION,DetonatioN FocusMe,DetonatioN FocusMe,ZETA DIVISION,Sunset,9,13,4,5,0,7,6,0,2,DetonatioN FocusMe,Attack,0,DetonatioN FocusMe,-4,22,ZETA DIVISION,5,7,-2
609,ZETA DIVISION,DetonatioN FocusMe,DetonatioN FocusMe,ZETA DIVISION,Ascent,10,13,6,4,0,7,6,0,3,DetonatioN FocusMe,Defense,0,DetonatioN FocusMe,-3,23,,6,6,0
610,DRX,Rex Regum Qeon,DRX,Rex Regum Qeon,Split,12,14,3,9,0,3,9,2,1,Rex Regum Qeon,Attack,1,Rex Regum Qeon,-2,26,DRX,9,3,6
610,Rex Regum Qeon,DRX,DRX,Rex Regum Qeon,Sunset,14,12,4,8,2,4,8,0,2,DRX,Attack,1,Rex Regum Qeon,2,26,Rex Regum Qeon,8,4,4
611,Team Secret,T1,Team Secret,T1,Haven,10,13,4,6,0,6,7,0,1,T1,Attack,0,T1,-3,23,Team Secret,6,6,0
611,T1,Team Secret,Team Secret,T1,Split,6,13,1,5,0,7,6,0,2,Team Secret,Attack,0,Team Secret,-7,19,T1,5,7,-2
611,T1,Team Secret,Team Secret,T1,Icebox,12,14,8,4,0,8,4,2,3,Team Secret,Attack,1,Team Secret,-2,26,,4,8,-4
612,TALON,DetonatioN FocusMe,TALON,DetonatioN FocusMe,Lotus,13,7,7,6,0,2,5,0,1,DetonatioN FocusMe,Defense,0,TALON,6,20,TALON,7,5,2
612,DetonatioN FocusMe,TALON,TALON,DetonatioN FocusMe,Sunset,10,13,4,6,0,6,7,0,2,TALON,Attack,0,TALON,-3,23,DetonatioN FocusMe,6,6,0
613,Rex Regum Qeon,ZETA DIVISION,Rex Regum Qeon,ZETA DIVISION,Split,13,8,7,6,0,6,2,0,1,ZETA DIVISION,Attack,0,Rex Regum Qeon,5,21,Rex Regum Qeon,6,6,0
613,ZETA DIVISION,Rex Regum Qeon,Rex Regum Qeon,ZETA DIVISION,Sunset,10,13,7,3,0,9,4,0,2,Rex Regum Qeon,Attack,0,Rex Regum Qeon,-3,23,ZETA DIVISION,3,9,-6
614,Global Esports,T1,Global Esports,T1,Icebox,13,10,6,7,0,5,5,0,1,T1,Attack,0,Global Esports,3,23,Global Esports,7,5,2
614,T1,Global Esports,Global Esports,T1,Lotus,13,8,5,8,0,4,4,0,2,Global Esports,Attack,0,T1,5,21,T1,8,4,4
614,T1,Global Esports,Global Esports,T1,Ascent,13,8,7,6,0,6,2,0,3,Global Esports,Attack,0,T1,5,21,,6,6,0
615,BLEED,Gen.G,BLEED,Gen.G,Ascent,6,13,6,0,0,7,6,0,1,Gen.G,Defense,0,Gen.G,-7,19,BLEED,6,6,0
615,Gen.G,BLEED,BLEED,Gen.G,Sunset,10,13,7,3,0,8,5,0,2,BLEED,Defense,0,BLEED,-3,23,Gen.G,7,5,2
615,Gen.G,BLEED,BLEED,Gen.G,Icebox,13,11,8,5,0,7,4,0,3,BLEED,Defense,0,Gen.G,2,24,,8,4,4
616,DetonatioN FocusMe,Paper Rex,DetonatioN FocusMe,Paper Rex,Icebox,4,13,2,2,0,10,3,0,1,Paper Rex,Attack,0,Paper Rex,-9,17,DetonatioN FocusMe,2,10,-8
616,Paper Rex,DetonatioN FocusMe,DetonatioN FocusMe,Paper Rex,Sunset,13,8,5,8,0,4,4,0,2,DetonatioN FocusMe,Attack,0,Paper Rex,5,21,Paper Rex,8,4,4
617,DRX,TALON,DRX,TALON,Ascent,11,13,8,3,0,9,4,0,1,TALON,Attack,0,TALON,-2,24,DRX,3,9,-6
617,TALON,DRX,DRX,TALON,Haven,10,13,5,5,0,7,6,0,2,DRX,Attack,0,DRX,-3,23,TALON,5,7,-2
617,TALON,DRX,DRX,TALON,Icebox,5,13,5,0,0,12,1,0,3,DRX,Attack,0,DRX,-8,18,,0,12,-12
618,Paper Rex,Rex Regum Qeon,Paper Rex,Rex Regum Qeon,Lotus,13,7,5,8,0,4,3,0,1,Rex Regum Qeon,Attack,0,Paper Rex,6,20,Paper Rex,8,4,4
618,Rex Regum Qeon,Paper Rex,Paper Rex,Rex Regum Qeon,Ascent,13,7,6,7,0,5,2,0,2,Paper Rex,Attack,0,Rex Regum Qeon,6,20,Rex Regum Qeon,7,5,2
618,Rex Regum Qeon,Paper Rex,Paper Rex,Rex Regum Qeon,Sunset,10,13,5,5,0,7,6,0,3,Paper Rex,Attack,0,Paper Rex,-3,23,,5,7,-2
619,Global Esports,Gen.G,Global Esports,Gen.G,Lotus,1,13,1,0,0,2,11,0,1,Gen.G,Defense,0,Gen.G,-12,14,Global Esports,1,11,-10
619,Gen.G,Global Esports,Global Esports,Gen.G,Ascent,13,6,6,7,0,5,1,0,2,Global Esports,Attack,0,Gen.G,7,19,Gen.G,7,5,2
620,DRX,DetonatioN FocusMe,DRX,DetonatioN FocusMe,Icebox,13,7,6,7,0,5,2,0,1,DetonatioN FocusMe,Attack,0,DRX,6,20,DRX,7,5,2
620,DetonatioN FocusMe,DRX,DRX,DetonatioN FocusMe,Ascent,13,6,6,7,0,5,1,0,2,DRX,Attack,0,DetonatioN FocusMe,7,19,DetonatioN FocusMe,7,5,2
620,DetonatioN FocusMe,DRX,DRX,DetonatioN FocusMe,Haven,2,13,0,2,0,10,3,0,3,DRX,Attack,0,DRX,-11,15,,2,10,-8
621,ZETA DIVISION,TALON,ZETA DIVISION,TALON,Ascent,13,6,4,9,0,3,3,0,1,TALON,Attack,0,ZETA DIVISION,7,19,ZETA DIVISION,9,3,6
621,TALON,ZETA DIVISION,ZETA DIVISION,TALON,Lotus,13,8,6,7,0,2,6,0,2,ZETA DIVISION,Defense,0,TALON,5,21,TALON,6,6,0
621,TALON,ZETA DIVISION,ZETA DIVISION,TALON,Haven,8,13,3,5,0,7,6,0,3,ZETA DIVISION,Attack,0,ZETA DIVISION,-5,21,,5,7,-2
622,Team Secret,Gen.G,Team Secret,Gen.G,Sunset,13,6,10,3,0,4,2,0,1,Gen.G,Defense,0,Team Secret,7,19,Team Secret,10,2,8
622,Gen.G,Team Secret,Team Secret,Gen.G,Lotus,13,7,6,7,0,5,2,0,2,Team Secret,Attack,0,Gen.G,6,20,Gen.G,7,5,2
622,Gen.G,Team Secret,Team Secret,Gen.G,Split,12,14,3,9,0,3,9,2,3,Team Secret,Attack,1,Team Secret,-2,26,,9,3,6
623,ZETA DIVISION,Paper Rex,ZETA DIVISION,Paper Rex,Ascent,13,9,8,5,0,7,2,0,1,Paper Rex,Attack,0,ZETA DIVISION,4,22,ZETA DIVISION,5,7,-2
623,Paper Rex,ZETA DIVISION,ZETA DIVISION,Paper Rex,Lotus,13,8,11,2,0,7,1,0,2,ZETA DIVISION,Defense,0,Paper Rex,5,21,Paper Rex,11,1,10
623,Paper Rex,ZETA DIVISION,ZETA DIVISION,Paper Rex,Sunset,13,4,5,8,0,4,0,0,3,ZETA DIVISION,Attack,0,Paper Rex,9,17,,8,4,4
624,BLEED,T1,BLEED,T1,Bind,11,13,2,9,0,3,10,0,1,T1,Attack,0,T1,-2,24,BLEED,9,3,6
624,T1,BLEED,BLEED,T1,Lotus,9,13,3,6,0,6,7,0,2,BLEED,Attack,0,BLEED,-4,22,T1,6,6,0
624,T1,BLEED,BLEED,T1,Ascent,13,8,7,6,0,3,5,0,3,BLEED,Defense,0,T1,5,21,,7,5,2
625,Rex Regum Qeon,Gen.G,Rex Regum Qeon,Gen.G,Haven,8,13,5,3,0,6,7,0,1,Gen.G,Defense,0,Gen.G,-5,21,Rex Regum Qeon,5,7,-2
625,Gen.G,Rex Regum Qeon,Rex Regum Qeon,Gen.G,Bind,13,11,7,6,0,6,5,0,2,Rex Regum Qeon,Attack,0,Gen.G,2,24,Gen.G,6,6,0
626,TALON,Team Secret,TALON,Team Secret,Lotus,13,11,6,7,0,5,6,0,1,Team Secret,Attack,0,TALON,2,24,TALON,7,5,2
626,Team Secret,TALON,TALON,Team Secret,Abyss,11,13,5,6,0,6,7,0,2,TALON,Attack,0,TALON,-2,24,Team Secret,6,6,0
627,Gen.G,Paper Rex,Gen.G,Paper Rex,Ascent,13,10,4,9,0,3,7,0,1,Paper Rex,Attack,0,Gen.G,3,23,Gen.G,9,3,6
627,Paper Rex,Gen.G,Gen.G,Paper Rex,Icebox,5,13,4,1,0,5,8,0,2,Gen.G,Defense,0,Gen.G,-8,18,Paper Rex,4,8,-4
628,TALON,DRX,TALON,DRX,Ascent,8,13,3,5,0,7,6,0,1,DRX,Attack,0,DRX,-5,21,TALON,5,7,-2
628,DRX,TALON,TALON,DRX,Abyss,13,4,5,8,0,4,0,0,2,TALON,Attack,0,DRX,9,17,DRX,8,4,4
629,Gen.G,DRX,Gen.G,DRX,Haven,13,9,4,9,0,3,6,0,1,DRX,Attack,0,Gen.G,4,22,Gen.G,9,3,6
629,DRX,Gen.G,Gen.G,DRX,Sunset,13,10,6,7,0,4,6,0,2,Gen.G,Defense,0,DRX,3,23,DRX,6,6,0
629,DRX,Gen.G,Gen.G,DRX,Bind,6,13,5,1,0,6,7,0,3,Gen.G,Defense,0,Gen.G,-7,19,,5,7,-2
630,TALON,Paper Rex,TALON,Paper Rex,Ascent,3,13,2,1,0,3,10,0,1,Paper Rex,Defense,0,Paper Rex,-10,16,TALON,2,10,-8
630,Paper Rex,TALON,TALON,Paper Rex,Sunset,13,3,9,4,0,0,3,0,2,TALON,Defense,0,Paper Rex,10,16,Paper Rex,9,3,6
631,DRX,Paper Rex,DRX,Paper Rex,Abyss,7,13,1,6,0,6,7,0,1,Paper Rex,Attack,0,Paper Rex,-6,20,DRX,6,6,0
631,Paper Rex,DRX,DRX,Paper Rex,Lotus,13,10,6,7,0,5,5,0,2,DRX,Attack,0,Paper Rex,3,23,Paper Rex,7,5,2
631,DRX,Paper Rex,DRX,Paper Rex,Bind,13,10,5,8,0,4,6,0,3,Paper Rex,Attack,0,DRX,3,23,DRX,8,4,4
631,Paper Rex,DRX,DRX,Paper Rex,Icebox,10,13,4,6,0,6,7,0,4,DRX,Attack,0,DRX,-3,23,Paper Rex,6,6,0
631,DRX,Paper Rex,DRX,Paper Rex,Ascent,13,7,7,6,0,2,5,0,5,Paper Rex,Defense,0,DRX,6,20,,7,5,2
632,Gen.G,DRX,Gen.G,DRX,Haven,6,13,4,2,0,10,3,0,1,DRX,Attack,0,DRX,-7,19,Gen.G,2,10,-8
632,DRX,Gen.G,Gen.G,DRX,Bind,16,18,5,7,4,5,7,6,2,Gen.G,Defense,1,Gen.G,-2,34,DRX,5,7,-2
632,Gen.G,DRX,Gen.G,DRX,Lotus,14,12,7,5,2,7,5,0,3,DRX,Attack,1,Gen.G,2,26,Gen.G,5,7,-2
632,DRX,Gen.G,Gen.G,DRX,Icebox,6,13,5,1,0,6,7,0,4,Gen.G,Defense,0,Gen.G,-7,19,DRX,5,7,-2
633,JDG Esports,Titan Esports Club,JDG Esports,Titan Esports Club,Icebox,14,12,4,8,2,4,8,0,1,Titan Esports Club,Attack,1,JDG Esports,2,26,JDG Esports,8,4,4
633,Titan Esports Club,JDG Esports,JDG Esports,Titan Esports Club,Lotus,11,13,8,3,0,9,4,0,2,JDG Esports,Attack,0,JDG Esports,-2,24,Titan Esports Club,3,9,-6
634,All Gamers,TYLOO,All Gamers,TYLOO,Sunset,13,10,7,6,0,5,5,0,1,TYLOO,Defense,0,All Gamers,3,23,All Gamers,7,5,2
634,TYLOO,All Gamers,All Gamers,TYLOO,Icebox,4,13,0,4,0,8,5,0,2,All Gamers,Attack,0,All Gamers,-9,17,TYLOO,4,8,-4
635,Wolves Esports,Bilibili Gaming,Wolves Esports,Bilibili Gaming,Sunset,5,13,3,2,0,4,9,0,1,Bilibili Gaming,Defense,0,Bilibili Gaming,-8,18,Wolves Esports,3,9,-6
635,Bilibili Gaming,Wolves Esports,Wolves Esports,Bilibili Gaming,Bind,13,7,4,9,0,3,4,0,2,Wolves Esports,Attack,0,Bilibili Gaming,6,20,Bilibili Gaming,9,3,6
636,Dragon Ranger Gaming,Nova Esports,Dragon Ranger Gaming,Nova Esports,Ascent,13,7,6,7,0,1,6,0,1,Nova Esports,Defense,0,Dragon Ranger Gaming,6,20,Dragon Ranger Gaming,6,6,0
636,Nova Esports,Dragon Ranger Gaming,Dragon Ranger Gaming,Nova Esports,Lotus,14,12,8,4,2,8,4,0,2,Dragon Ranger Gaming,Attack,1,Nova Esports,2,26,Nova Esports,4,8,-4
636,Nova Esports,Dragon Ranger Gaming,Dragon Ranger Gaming,Nova Esports,Sunset,13,5,9,4,0,2,3,0,3,Dragon Ranger Gaming,Defense,0,Nova Esports,8,18,,9,3,6
637,Trace Esports,FunPlus Phoenix,Trace Esports,FunPlus Phoenix,Haven,5,13,3,2,0,10,3,0,1,FunPlus Phoenix,Attack,0,FunPlus Phoenix,-8,18,Trace Esports,2,10,-8
637,FunPlus Phoenix,Trace Esports,Trace Esports,FunPlus Phoenix,Lotus,13,15,3,9,1,3,9,3,2,Trace Esports,Attack,1,Trace Esports,-2,28,FunPlus Phoenix,9,3,6
637,FunPlus Phoenix,Trace Esports,Trace Esports,FunPlus Phoenix,Sunset,6,13,1,5,0,7,6,0,3,Trace Esports,Attack,0,Trace Esports,-7,19,,5,7,-2
638,All Gamers,Titan Esports Club,All Gamers,Titan Esports Club,Sunset,13,10,9,4,0,8,2,0,1,Titan Esports Club,Attack,0,All Gamers,3,23,All Gamers,4,8,-4
638,Titan Esports Club,All Gamers,All Gamers,Titan Esports Club,Icebox,6,13,3,3,0,9,4,0,2,All Gamers,Attack,0,All Gamers,-7,19,Titan Esports Club,3,9,-6
639,Wolves Esports,EDward Gaming,Wolves Esports,EDward Gaming,Split,7,13,3,4,0,4,9,0,1,EDward Gaming,Defense,0,EDward Gaming,-6,20,Wolves Esports,3,9,-6
639,EDward Gaming,Wolves Esports,Wolves Esports,EDward Gaming,Bind,12,14,5,7,0,5,7,2,2,Wolves Esports,Attack,1,Wolves Esports,-2,26,EDward Gaming,7,5,2
639,EDward Gaming,Wolves Esports,Wolves Esports,EDward Gaming,Icebox,7,13,5,2,0,6,7,0,3,Wolves Esports,Defense,0,Wolves Esports,-6,20,,5,7,-2
640,TYLOO,Trace Esports,TYLOO,Trace Esports,Split,11,13,7,4,0,8,5,0,1,Trace Esports,Defense,0,Trace Esports,-2,24,TYLOO,7,5,2
640,Trace Esports,TYLOO,TYLOO,Trace Esports,Sunset,7,13,2,5,0,7,6,0,2,TYLOO,Attack,0,TYLOO,-6,20,Trace Esports,5,7,-2
640,Trace Esports,TYLOO,TYLOO,Trace Esports,Haven,13,4,5,8,0,4,0,0,3,TYLOO,Attack,0,Trace Esports,9,17,,8,4,4
641,Bilibili Gaming,Nova Esports,Bilibili Gaming,Nova Esports,Split,14,16,4,8,2,4,8,4,1,Nova Esports,Defense,1,Nova Esports,-2,30,Bilibili Gaming,4,8,-4
641,Nova Esports,Bilibili Gaming,Bilibili Gaming,Nova Esports,Bind,9,13,4,5,0,5,8,0,2,Bilibili Gaming,Defense,0,Bilibili Gaming,-4,22,Nova Esports,4,8,-4
641,Nova Esports,Bilibili Gaming,Bilibili Gaming,Nova Esports,Ascent,6,13,3,3,0,4,9,0,3,Bilibili Gaming,Defense,0,Bilibili Gaming,-7,19,,3,9,-6
642,JDG Esports,FunPlus Phoenix,JDG Esports,FunPlus Phoenix,Sunset,8,13,4,4,0,8,5,0,1,FunPlus Phoenix,Attack,0,FunPlus Phoenix,-5,21,JDG Esports,4,8,-4
642,FunPlus Phoenix,JDG Esports,JDG Esports,FunPlus Phoenix,Haven,14,12,5,7,2,5,7,0,2,JDG Esports,Defense,1,FunPlus Phoenix,2,26,FunPlus Phoenix,5,7,-2
643,EDward Gaming,Dragon Ranger Gaming,EDward Gaming,Dragon Ranger Gaming,Lotus,11,13,4,7,0,5,8,0,1,Dragon Ranger Gaming,Attack,0,Dragon Ranger Gaming,-2,24,EDward Gaming,7,5,2
643,Dragon Ranger Gaming,EDward Gaming,EDward Gaming,Dragon Ranger Gaming,Haven,13,5,4,9,0,3,2,0,2,EDward Gaming,Attack,0,Dragon Ranger Gaming,8,18,Dragon Ranger Gaming,9,3,6
644,Wolves Esports,Nova Esports,Wolves Esports,Nova Esports,Icebox,12,14,10,2,0,10,2,2,1,Nova Esports,Defense,1,Nova Esports,-2,26,Wolves Esports,10,2,8
644,Nova Esports,Wolves Esports,Wolves Esports,Nova Esports,Sunset,15,13,4,8,3,4,8,1,2,Wolves Esports,Attack,1,Nova Esports,2,28,Nova Esports,8,4,4
645,JDG Esports,Trace Esports,JDG Esports,Trace Esports,Bind,13,2,3,10,0,2,0,0,1,Trace Esports,Attack,0,JDG Esports,11,15,JDG Esports,10,2,8
645,Trace Esports,JDG Esports,JDG Esports,Trace Esports,Sunset,13,8,9,4,0,5,3,0,2,JDG Esports,Defense,0,Trace Esports,5,21,Trace Esports,9,3,6
645,Trace Esports,JDG Esports,JDG Esports,Trace Esports,Haven,6,13,5,1,0,6,7,0,3,JDG Esports,Defense,0,JDG Esports,-7,19,,5,7,-2
646,Titan Esports Club,TYLOO,Titan Esports Club,TYLOO,Bind,11,13,2,9,0,3,10,0,1,TYLOO,Attack,0,TYLOO,-2,24,Titan Esports Club,9,3,6
646,TYLOO,Titan Esports Club,Titan Esports Club,TYLOO,Ascent,9,13,3,6,0,6,7,0,2,Titan Esports Club,Attack,0,Titan Esports Club,-4,22,TYLOO,6,6,0
646,TYLOO,Titan Esports Club,Titan Esports Club,TYLOO,Icebox,13,9,7,6,0,6,3,0,3,Titan Esports Club,Attack,0,TYLOO,4,22,,6,6,0
647,All Gamers,FunPlus Phoenix,All Gamers,FunPlus Phoenix,Sunset,11,13,5,6,0,6,7,0,1,FunPlus Phoenix,Attack,0,FunPlus Phoenix,-2,24,All Gamers,6,6,0
647,FunPlus Phoenix,All Gamers,All Gamers,FunPlus Phoenix,Haven,8,13,2,6,0,6,7,0,2,All Gamers,Attack,0,All Gamers,-5,21,FunPlus Phoenix,6,6,0
647,FunPlus Phoenix,All Gamers,All Gamers,FunPlus Phoenix,Ascent,13,7,7,6,0,2,5,0,3,All Gamers,Defense,0,FunPlus Phoenix,6,20,,7,5,2
648,Bilibili Gaming,Dragon Ranger Gaming,Bilibili Gaming,Dragon Ranger Gaming,Lotus,13,11,7,6,0,6,5,0,1,Dragon Ranger Gaming,Attack,0,Bilibili Gaming,2,24,Bilibili Gaming,6,6,0
648,Dragon Ranger Gaming,Bilibili Gaming,Bilibili Gaming,Dragon Ranger Gaming,Ascent,11,13,4,7,0,5,8,0,2,Bilibili Gaming,Defense,0,Bilibili Gaming,-2,24,Dragon Ranger Gaming,4,8,-4
649,Nova Esports,EDward Gaming,Nova Esports,EDward Gaming,Lotus,9,13,5,4,0,6,7,0,1,EDward Gaming,Defense,0,EDward Gaming,-4,22,Nova Esports,5,7,-2
649,EDward Gaming,Nova Esports,Nova Esports,EDward Gaming,Bind,13,6,8,5,0,2,4,0,2,Nova Esports,Defense,0,EDward Gaming,7,19,EDward Gaming,8,4,4
650,All Gamers,Trace Esports,All Gamers,Trace Esports,Haven,6,13,4,2,0,10,3,0,1,Trace Esports,Attack,0,Trace Esports,-7,19,All Gamers,2,10,-8
650,Trace Esports,All Gamers,All Gamers,Trace Esports,Sunset,13,4,4,9,0,3,1,0,2,All Gamers,Attack,0,Trace Esports,9,17,Trace Esports,9,3,6
651,FunPlus Phoenix,Titan Esports Club,FunPlus Phoenix,Titan Esports Club,Lotus,9,13,3,6,0,6,7,0,1,Titan Esports Club,Attack,0,Titan Esports Club,-4,22,FunPlus Phoenix,6,6,0
651,Titan Esports Club,FunPlus Phoenix,FunPlus Phoenix,Titan Esports Club,Sunset,13,6,5,8,0,4,2,0,2,FunPlus Phoenix,Attack,0,Titan Esports Club,7,19,Titan Esports Club,8,4,4
652,JDG Esports,TYLOO,JDG Esports,TYLOO,Haven,13,1,2,11,0,1,0,0,1,TYLOO,Attack,0,JDG Esports,12,14,JDG Esports,11,1,10
652,TYLOO,JDG Esports,JDG Esports,TYLOO,Icebox,9,13,7,2,0,8,5,0,2,JDG Esports,Defense,0,JDG Esports,-4,22,TYLOO,7,5,2
653,Wolves Esports,Dragon Ranger Gaming,Wolves Esports,Dragon Ranger Gaming,Icebox,13,7,7,6,0,2,5,0,1,Dragon Ranger Gaming,Defense,0,Wolves Esports,6,20,Wolves Esports,7,5,2
653,Dragon Ranger Gaming,Wolves Esports,Wolves Esports,Dragon Ranger Gaming,Ascent,6,13,4,2,0,5,8,0,2,Wolves Esports,Defense,0,Wolves Esports,-7,19,Dragon Ranger Gaming,4,8,-4
654,Trace Esports,Titan Esports Club,Trace Esports,Titan Esports Club,Lotus,13,11,6,7,0,5,6,0,1,Titan Esports Club,Attack,0,Trace Esports,2,24,Trace Esports,7,5,2
654,Titan Esports Club,Trace Esports,Trace Esports,Titan Esports Club,Bind,13,8,8,5,0,4,4,0,2,Trace Esports,Defense,0,Titan Esports Club,5,21,Titan Esports Club,8,4,4
654,Titan Esports Club,Trace Esports,Trace Esports,Titan Esports Club,Haven,10,13,5,5,0,7,6,0,3,Trace Esports,Attack,0,Trace Esports,-3,23,,5,7,-2
655,Bilibili Gaming,EDward Gaming,Bilibili Gaming,EDward Gaming,Icebox,11,13,6,5,0,7,6,0,1,EDward Gaming,Attack,0,EDward Gaming,-2,24,Bilibili Gaming,5,7,-2
655,EDward Gaming,Bilibili Gaming,Bilibili Gaming,EDward Gaming,Haven,13,8,5,8,0,4,4,0,2,Bilibili Gaming,Attack,0,EDward Gaming,5,21,EDward Gaming,8,4,4
656,JDG Esports,All Gamers,JDG Esports,All Gamers,Haven,13,8,7,6,0,3,5,0,1,All Gamers,Defense,0,JDG Esports,5,21,JDG Esports,7,5,2
656,All Gamers,JDG Esports,JDG Esports,All Gamers,Icebox,3,13,2,1,0,3,10,0,2,JDG Esports,Defense,0,JDG Esports,-10,16,All Gamers,2,10,-8
657,TYLOO,FunPlus Phoenix,TYLOO,FunPlus Phoenix,Icebox,5,13,1,4,0,8,5,0,1,FunPlus Phoenix,Attack,0,FunPlus Phoenix,-8,18,TYLOO,4,8,-4
657,FunPlus Phoenix,TYLOO,TYLOO,FunPlus Phoenix,Haven,12,14,6,6,0,6,6,2,2,TYLOO,Defense,1,TYLOO,-2,26,FunPlus Phoenix,6,6,0
657,FunPlus Phoenix,TYLOO,TYLOO,FunPlus Phoenix,Ascent,4,13,3,1,0,4,9,0,3,TYLOO,Defense,0,TYLOO,-9,17,,3,9,-6
658,All Gamers,Trace Esports,All Gamers,Trace Esports,Lotus,7,13,4,3,0,9,4,0,1,Trace Esports,Attack,0,Trace Esports,-6,20,All Gamers,3,9,-6
658,Trace Esports,All Gamers,All Gamers,Trace Esports,Sunset,13,10,8,5,0,7,3,0,2,All Gamers,Attack,0,Trace Esports,3,23,Trace Esports,5,7,-2
659,Bilibili Gaming,JDG Esports,Bilibili Gaming,JDG Esports,Sunset,13,9,7,6,0,4,5,0,1,JDG Esports,Defense,0,Bilibili Gaming,4,22,Bilibili Gaming,7,5,2
659,JDG Esports,Bilibili Gaming,Bilibili Gaming,JDG Esports,Icebox,7,13,2,5,0,7,6,0,2,Bilibili Gaming,Attack,0,Bilibili Gaming,-6,20,JDG Esports,5,7,-2
660,Trace Esports,FunPlus Phoenix,Trace Esports,FunPlus Phoenix,Ascent,13,3,4,9,0,3,0,0,1,FunPlus Phoenix,Attack,0,Trace Esports,10,16,Trace Esports,9,3,6
660,FunPlus Phoenix,Trace Esports,Trace Esports,FunPlus Phoenix,Haven,11,13,8,3,0,9,4,0,2,Trace Esports,Attack,0,Trace Esports,-2,24,FunPlus Phoenix,3,9,-6
661,Bilibili Gaming,EDward Gaming,Bilibili Gaming,EDward Gaming,Sunset,5,13,0,5,0,7,6,0,1,EDward Gaming,Attack,0,EDward Gaming,-8,18,Bilibili Gaming,5,7,-2
661,EDward Gaming,Bilibili Gaming,Bilibili Gaming,EDward Gaming,Bind,7,13,4,3,0,5,8,0,2,Bilibili Gaming,Defense,0,Bilibili Gaming,-6,20,EDward Gaming,4,8,-4
661,EDward Gaming,Bilibili Gaming,Bilibili Gaming,EDward Gaming,Lotus,13,10,9,4,0,7,3,0,3,Bilibili Gaming,Defense,0,EDward Gaming,3,23,,9,3,6
662,Trace Esports,EDward Gaming,Trace Esports,EDward Gaming,Sunset,2,13,0,2,0,10,3,0,1,EDward Gaming,Attack,0,EDward Gaming,-11,15,Trace Esports,2,10,-8
662,EDward Gaming,Trace Esports,Trace Esports,EDward Gaming,Abyss,13,5,6,7,0,5,0,0,2,Trace Esports,Attack,0,EDward Gaming,8,18,EDward Gaming,7,5,2
663,Bilibili Gaming,FunPlus Phoenix,Bilibili Gaming,FunPlus Phoenix,Ascent,3,13,3,0,0,4,9,0,1,FunPlus Phoenix,Defense,0,FunPlus Phoenix,-10,16,Bilibili Gaming,3,9,-6
663,FunPlus Phoenix,Bilibili Gaming,Bilibili Gaming,FunPlus Phoenix,Icebox,12,14,7,5,0,7,5,2,2,Bilibili Gaming,Attack,1,Bilibili Gaming,-2,26,FunPlus Phoenix,5,7,-2
663,FunPlus Phoenix,Bilibili Gaming,Bilibili Gaming,FunPlus Phoenix,Lotus,13,10,7,6,0,6,4,0,3,Bilibili Gaming,Attack,0,FunPlus Phoenix,3,23,,6,6,0
664,FunPlus Phoenix,Trace Esports,FunPlus Phoenix,Trace Esports,Lotus,11,13,6,5,0,7,6,0,1,Trace Esports,Attack,0,Trace Esports,-2,24,FunPlus Phoenix,5,7,-2
664,Trace Esports,FunPlus Phoenix,FunPlus Phoenix,Trace Esports,Ascent,13,8,6,7,0,2,6,0,2,FunPlus Phoenix,Defense,0,Trace Esports,5,21,Trace Esports,6,6,0
664,FunPlus Phoenix,Trace Esports,FunPlus Phoenix,Trace Esports,Abyss,13,8,6,7,0,5,3,0,3,Trace Esports,Attack,0,FunPlus Phoenix,5,21,FunPlus Phoenix,7,5,2
664,Trace Esports,FunPlus Phoenix,FunPlus Phoenix,Trace Esports,Bind,9,13,6,3,0,7,6,0,4,FunPlus Phoenix,Defense,0,FunPlus Phoenix,-4,22,Trace Esports,6,6,0
664,FunPlus Phoenix,Trace Esports,FunPlus Phoenix,Trace Esports,Haven,13,8,7,6,0,6,2,0,5,Trace Esports,Attack,0,FunPlus Phoenix,5,21,,6,6,0
665,EDward Gaming,FunPlus Phoenix,EDward Gaming,FunPlus Phoenix,Sunset,13,9,9,4,0,6,3,0,1,FunPlus Phoenix,Defense,0,EDward Gaming,4,22,EDward Gaming,9,3,6
665,FunPlus Phoenix,EDward Gaming,EDward Gaming,FunPlus Phoenix,Abyss,13,8,6,7,0,5,3,0,2,EDward Gaming,Attack,0,FunPlus Phoenix,5,21,FunPlus Phoenix,7,5,2
665,EDward Gaming,FunPlus Phoenix,EDward Gaming,FunPlus Phoenix,Haven,13,7,4,9,0,3,4,0,3,FunPlus Phoenix,Attack,0,EDward Gaming,6,20,EDward Gaming,9,3,6
665,FunPlus Phoenix,EDward Gaming,EDward Gaming,FunPlus Phoenix,Icebox,13,9,8,5,0,7,2,0,4,EDward Gaming,Attack,0,FunPlus Phoenix,4,22,FunPlus Phoenix,5,7,-2
665,EDward Gaming,FunPlus Phoenix,EDward Gaming,FunPlus Phoenix,Bind,13,8,10,3,0,6,2,0,5,FunPlus Phoenix,Defense,0,EDward Gaming,5,21,,10,2,8
666,KOI,FUT Esports,KOI,FUT Esports,Split,7,13,4,3,0,5,8,0,1,FUT Esports,Defense,0,FUT Esports,-6,20,KOI,4,8,-4
666,FUT Esports,KOI,KOI,FUT Esports,Lotus,7,13,4,3,0,9,4,0,2,KOI,Attack,0,KOI,-6,20,FUT Esports,3,9,-6
666,FUT Esports,KOI,KOI,FUT Esports,Sunset,13,6,10,3,0,4,2,0,3,KOI,Defense,0,FUT Esports,7,19,,10,2,8
667,BBL Esports,FNATIC,BBL Esports,FNATIC,Ascent,9,13,6,3,0,7,6,0,1,FNATIC,Defense,0,FNATIC,-4,22,BBL Esports,6,6,0
667,FNATIC,BBL Esports,BBL Esports,FNATIC,Bind,11,13,4,7,0,5,8,0,2,BBL Esports,Defense,0,BBL Esports,-2,24,FNATIC,4,8,-4
667,FNATIC,BBL Esports,BBL Esports,FNATIC,Lotus,13,11,4,9,0,3,8,0,3,BBL Esports,Defense,0,FNATIC,2,24,,4,8,-4
668,Team Heretics,Natus Vincere,Team Heretics,Natus Vincere,Sunset,13,3,2,11,0,1,2,0,1,Natus Vincere,Attack,0,Team Heretics,10,16,Team Heretics,11,1,10
668,Natus Vincere,Team Heretics,Team Heretics,Natus Vincere,Bind,5,13,2,3,0,9,4,0,2,Team Heretics,Attack,0,Team Heretics,-8,18,Natus Vincere,3,9,-6
669,Gentle Mates,GIANTX,Gentle Mates,GIANTX,Split,13,1,11,2,0,0,1,0,1,GIANTX,Defense,0,Gentle Mates,12,14,Gentle Mates,11,1,10
669,GIANTX,Gentle Mates,Gentle Mates,GIANTX,Sunset,13,11,6,7,0,5,6,0,2,Gentle Mates,Defense,0,GIANTX,2,24,GIANTX,6,6,0
669,GIANTX,Gentle Mates,Gentle Mates,GIANTX,Breeze,13,11,5,8,0,4,7,0,3,Gentle Mates,Defense,0,GIANTX,2,24,,5,7,-2
670,Team Liquid,Team Vitality,Team Liquid,Team Vitality,Lotus,10,13,6,4,0,8,5,0,1,Team Vitality,Attack,0,Team Vitality,-3,23,Team Liquid,4,8,-4
670,Team Vitality,Team Liquid,Team Liquid,Team Vitality,Icebox,17,15,10,2,5,10,2,3,2,Team Liquid,Defense,1,Team Vitality,2,32,Team Vitality,10,2,8
671,Karmine Corp,BBL Esports,Karmine Corp,BBL Esports,Lotus,13,6,6,7,0,0,6,0,1,BBL Esports,Defense,0,Karmine Corp,7,19,Karmine Corp,6,6,0
671,BBL Esports,Karmine Corp,Karmine Corp,BBL Esports,Sunset,5,13,3,2,0,10,3,0,2,Karmine Corp,Attack,0,Karmine Corp,-8,18,BBL Esports,2,10,-8
672,Natus Vincere,FUT Esports,Natus Vincere,FUT Esports,Ascent,11,13,7,4,0,8,5,0,1,FUT Esports,Defense,0,FUT Esports,-2,24,Natus Vincere,7,5,2
672,FUT Esports,Natus Vincere,Natus Vincere,FUT Esports,Lotus,13,5,6,7,0,5,0,0,2,Natus Vincere,Attack,0,FUT Esports,8,18,FUT Esports,7,5,2
673,GIANTX,KOI,GIANTX,KOI,Sunset,5,13,0,5,0,7,6,0,1,KOI,Attack,0,KOI,-8,18,GIANTX,5,7,-2
673,KOI,GIANTX,GIANTX,KOI,Icebox,14,12,8,4,2,8,4,0,2,GIANTX,Attack,1,KOI,2,26,KOI,4,8,-4
674,Team Heretics,FUT Esports,Team Heretics,FUT Esports,Sunset,13,10,7,6,0,6,4,0,1,FUT Esports,Attack,0,Team Heretics,3,23,Team Heretics,6,6,0
674,FUT Esports,Team Heretics,Team Heretics,FUT Esports,Split,6,13,3,3,0,4,9,0,2,Team Heretics,Defense,0,Team Heretics,-7,19,FUT Esports,3,9,-6
675,FNATIC,Team Vitality,FNATIC,Team Vitality,Haven,13,6,9,4,0,3,3,0,1,Team Vitality,Defense,0,FNATIC,7,19,FNATIC,9,3,6
675,Team Vitality,FNATIC,FNATIC,Team Vitality,Icebox,13,6,4,9,0,3,3,0,2,FNATIC,Attack,0,Team Vitality,7,19,Team Vitality,9,3,6
675,Team Vitality,FNATIC,FNATIC,Team Vitality,Lotus,7,13,3,4,0,8,5,0,3,FNATIC,Attack,0,FNATIC,-6,20,,4,8,-4
676,Team Liquid,BBL Esports,Team Liquid,BBL Esports,Lotus,6,13,5,1,0,6,7,0,1,BBL Esports,Defense,0,BBL Esports,-7,19,Team Liquid,5,7,-2
676,BBL Esports,Team Liquid,Team Liquid,BBL Esports,Ascent,13,5,7,6,0,0,5,0,2,Team Liquid,Defense,0,BBL Esports,8,18,BBL Esports,7,5,2
677,GIANTX,Natus Vincere,GIANTX,Natus Vincere,Lotus,13,9,5,8,0,4,5,0,1,Natus Vincere,Attack,0,GIANTX,4,22,GIANTX,8,4,4
677,Natus Vincere,GIANTX,GIANTX,Natus Vincere,Ascent,8,13,3,5,0,7,6,0,2,GIANTX,Attack,0,GIANTX,-5,21,Natus Vincere,5,7,-2
678,KOI,Gentle Mates,KOI,Gentle Mates,Sunset,11,13,7,4,0,8,5,0,1,Gentle Mates,Defense,0,Gentle Mates,-2,24,KOI,7,5,2
678,Gentle Mates,KOI,KOI,Gentle Mates,Split,13,11,7,6,0,6,5,0,2,KOI,Attack,0,Gentle Mates,2,24,Gentle Mates,6,6,0
679,FNATIC,Karmine Corp,FNATIC,Karmine Corp,Haven,13,3,4,9,0,3,0,0,1,Karmine Corp,Attack,0,FNATIC,10,16,FNATIC,9,3,6
679,Karmine Corp,FNATIC,FNATIC,Karmine Corp,Lotus,8,13,4,4,0,8,5,0,2,FNATIC,Attack,0,FNATIC,-5,21,Karmine Corp,4,8,-4
680,Team Heretics,GIANTX,Team Heretics,GIANTX,Bind,13,9,7,6,0,6,3,0,1,GIANTX,Attack,0,Team Heretics,4,22,Team Heretics,6,6,0
680,GIANTX,Team Heretics,Team Heretics,GIANTX,Split,15,13,8,4,3,8,4,1,2,Team Heretics,Defense,1,GIANTX,2,28,GIANTX,8,4,4
680,GIANTX,Team Heretics,Team Heretics,GIANTX,Haven,9,13,8,1,0,9,4,0,3,Team Heretics,Defense,0,Team Heretics,-4,22,,8,4,4
681,FUT Esports,Gentle Mates,FUT Esports,Gentle Mates,Sunset,13,8,8,5,0,4,4,0,1,Gentle Mates,Defense,0,FUT Esports,5,21,FUT Esports,8,4,4
681,Gentle Mates,FUT Esports,FUT Esports,Gentle Mates,Split,4,13,2,2,0,3,10,0,2,FUT Esports,Defense,0,FUT Esports,-9,17,Gentle Mates,2,10,-8
682,Natus Vincere,KOI,Natus Vincere,KOI,Split,10,13,7,3,0,9,4,0,1,KOI,Attack,0,KOI,-3,23,Natus Vincere,3,9,-6
682,KOI,Natus Vincere,Natus Vincere,KOI,Icebox,13,6,7,6,0,1,5,0,2,Natus Vincere,Defense,0,KOI,7,19,KOI,7,5,2
683,Karmine Corp,Team Liquid,Karmine Corp,Team Liquid,Bind,11,13,5,6,0,6,7,0,1,Team Liquid,Defense,0,Team Liquid,-2,24,Karmine Corp,5,7,-2
683,Team Liquid,Karmine Corp,Karmine Corp,Team Liquid,Sunset,13,2,10,3,0,0,2,0,2,Karmine Corp,Defense,0,Team Liquid,11,15,Team Liquid,10,2,8
684,BBL Esports,Team Vitality,BBL Esports,Team Vitality,Ascent,7,13,5,2,0,6,7,0,1,Team Vitality,Defense,0,Team Vitality,-6,20,BBL Esports,5,7,-2
684,Team Vitality,BBL Esports,BBL Esports,Team Vitality,Sunset,6,13,2,4,0,3,10,0,2,BBL Esports,Defense,0,BBL Esports,-7,19,Team Vitality,2,10,-8
684,Team Vitality,BBL Esports,BBL Esports,Team Vitality,Lotus,13,11,3,10,0,2,9,0,3,BBL Esports,Defense,0,Team Vitality,2,24,,3,9,-6
685,Team Heretics,Gentle Mates,Team Heretics,Gentle Mates,Sunset,13,7,8,5,0,3,4,0,1,Gentle Mates,Defense,0,Team Heretics,6,20,Team Heretics,8,4,4
685,Gentle Mates,Team Heretics,Team Heretics,Gentle Mates,Icebox,13,10,4,9,0,2,8,0,2,Team Heretics,Defense,0,Gentle Mates,3,23,Gentle Mates,4,8,-4
685,Gentle Mates,Team Heretics,Team Heretics,Gentle Mates,Lotus,5,13,3,2,0,4,9,0,3,Team Heretics,Defense,0,Team Heretics,-8,18,,3,9,-6
686,GIANTX,FUT Esports,GIANTX,FUT Esports,Split,4,13,1,3,0,2,11,0,1,FUT Esports,Defense,0,FUT Esports,-9,17,GIANTX,1,11,-10
686,FUT Esports,GIANTX,GIANTX,FUT Esports,Lotus,13,6,7,6,0,1,5,0,2,GIANTX,Defense,0,FUT Esports,7,19,FUT Esports,7,5,2
687,KOI,Team Heretics,KOI,Team Heretics,Icebox,13,11,7,6,0,6,5,0,1,Team Heretics,Defense,0,KOI,2,24,KOI,7,5,2
687,Team Heretics,KOI,KOI,Team Heretics,Bind,13,9,7,6,0,6,3,0,2,KOI,Attack,0,Team Heretics,4,22,Team Heretics,6,6,0
687,Team Heretics,KOI,KOI,Team Heretics,Haven,13,10,8,5,0,7,3,0,3,KOI,Attack,0,Team Heretics,3,23,,5,7,-2
688,Team Liquid,FNATIC,Team Liquid,FNATIC,Icebox,2,13,2,0,0,3,10,0,1,FNATIC,Defense,0,FNATIC,-11,15,Team Liquid,2,10,-8
688,FNATIC,Team Liquid,Team Liquid,FNATIC,Haven,13,9,6,7,0,5,4,0,2,Team Liquid,Attack,0,FNATIC,4,22,FNATIC,7,5,2
689,Gentle Mates,Natus Vincere,Gentle Mates,Natus Vincere,Sunset,7,13,7,0,0,8,5,0,1,Natus Vincere,Defense,0,Natus Vincere,-6,20,Gentle Mates,7,5,2
689,Natus Vincere,Gentle Mates,Gentle Mates,Natus Vincere,Ascent,8,13,6,2,0,7,6,0,2,Gentle Mates,Defense,0,Gentle Mates,-5,21,Natus Vincere,6,6,0
689,Natus Vincere,Gentle Mates,Gentle Mates,Natus Vincere,Split,13,11,6,7,0,5,6,0,3,Gentle Mates,Defense,0,Natus Vincere,2,24,,6,6,0
690,Team Vitality,Karmine Corp,Team Vitality,Karmine Corp,Icebox,13,4,4,9,0,3,1,0,1,Karmine Corp,Attack,0,Team Vitality,9,17,Team Vitality,9,3,6
690,Karmine Corp,Team Vitality,Team Vitality,Karmine Corp,Lotus,13,9,7,6,0,6,3,0,2,Team Vitality,Attack,0,Karmine Corp,4,22,Karmine Corp,6,6,0
690,Karmine Corp,Team Vitality,Team Vitality,Karmine Corp,Sunset,12,14,5,7,0,5,7,2,3,Team Vitality,Defense,1,Team Vitality,-2,26,,5,7,-2
691,Natus Vincere,Team Vitality,Natus Vincere,Team Vitality,Haven,13,8,7,6,0,6,2,0,1,Team Vitality,Attack,0,Natus Vincere,5,21,Natus Vincere,6,6,0
691,Team Vitality,Natus Vincere,Natus Vincere,Team Vitality,Sunset,13,5,10,3,0,3,2,0,2,Natus Vincere,Defense,0,Team Vitality,8,18,Team Vitality,10,2,8
691,Team Vitality,Natus Vincere,Natus Vincere,Team Vitality,Ascent,13,7,5,8,0,0,7,0,3,Natus Vincere,Defense,0,Team Vitality,6,20,,5,7,-2
692,FNATIC,Karmine Corp,FNATIC,Karmine Corp,Icebox,7,13,5,2,0,6,7,0,1,Karmine Corp,Defense,0,Karmine Corp,-6,20,FNATIC,5,7,-2
692,Karmine Corp,FNATIC,FNATIC,Karmine Corp,Sunset,13,15,6,6,1,6,6,3,2,FNATIC,Defense,1,FNATIC,-2,28,Karmine Corp,6,6,0
692,Karmine Corp,FNATIC,FNATIC,Karmine Corp,Lotus,6,13,2,4,0,8,5,0,3,FNATIC,Attack,0,FNATIC,-7,19,,4,8,-4
693,Team Vitality,Team Heretics,Team Vitality,Team Heretics,Icebox,12,14,3,9,0,3,9,2,1,Team Heretics,Defense,1,Team Heretics,-2,26,Team Vitality,3,9,-6
693,Team Heretics,Team Vitality,Team Vitality,Team Heretics,Sunset,10,13,5,5,0,6,7,0,2,Team Vitality,Defense,0,Team Vitality,-3,23,Team Heretics,5,7,-2
693,Team Heretics,Team Vitality,Team Vitality,Team Heretics,Bind,12,14,7,5,0,7,5,2,3,Team Vitality,Attack,1,Team Vitality,-2,26,,5,7,-2
694,FUT Esports,FNATIC,FUT Esports,FNATIC,Sunset,13,15,7,5,1,7,5,3,1,FNATIC,Defense,1,FNATIC,-2,28,FUT Esports,7,5,2
694,FNATIC,FUT Esports,FUT Esports,FNATIC,Haven,13,5,8,5,0,1,4,0,2,FUT Esports,Defense,0,FNATIC,8,18,FNATIC,8,4,4
695,FNATIC,Team Vitality,FNATIC,Team Vitality,Lotus,13,11,8,5,0,7,4,0,1,Team Vitality,Attack,0,FNATIC,2,24,FNATIC,5,7,-2
695,Team Vitality,FNATIC,FNATIC,Team Vitality,Sunset,6,13,3,3,0,4,9,0,2,FNATIC,Defense,0,FNATIC,-7,19,Team Vitality,3,9,-6
696,FUT Esports,Team Heretics,FUT Esports,Team Heretics,Abyss,10,13,4,6,0,6,7,0,1,Team Heretics,Attack,0,Team Heretics,-3,23,FUT Esports,6,6,0
696,Team Heretics,FUT Esports,FUT Esports,Team Heretics,Sunset,13,11,8,5,0,7,4,0,2,FUT Esports,Attack,0,Team Heretics,2,24,Team Heretics,5,7,-2
697,Team Vitality,Team Heretics,Team Vitality,Team Heretics,Icebox,6,13,3,3,0,4,9,0,1,Team Heretics,Defense,0,Team Heretics,-7,19,Team Vitality,3,9,-6
697,Team Heretics,Team Vitality,Team Vitality,Team Heretics,Sunset,4,13,4,0,0,5,8,0,2,Team Vitality,Defense,0,Team Vitality,-9,17,Team Heretics,4,8,-4
697,Team Vitality,Team Heretics,Team Vitality,Team Heretics,Lotus,13,3,4,9,0,3,0,0,3,Team Heretics,Attack,0,Team Vitality,10,16,Team Vitality,9,3,6
697,Team Heretics,Team Vitality,Team Vitality,Team Heretics,Haven,9,13,5,4,0,8,5,0,4,Team Vitality,Attack,0,Team Vitality,-4,22,Team Heretics,4,8,-4
698,FNATIC,Team Vitality,FNATIC,Team Vitality,Haven,13,8,4,9,0,3,5,0,1,Team Vitality,Attack,0,FNATIC,5,21,FNATIC,9,3,6
698,Team Vitality,FNATIC,FNATIC,Team Vitality,Ascent,13,9,8,5,0,5,4,0,2,FNATIC,Defense,0,Team Vitality,4,22,Team Vitality,8,4,4
698,FNATIC,Team Vitality,FNATIC,Team Vitality,Lotus,13,9,5,8,0,4,5,0,3,Team Vitality,Attack,0,FNATIC,4,22,FNATIC,8,4,4
698,Team Vitality,FNATIC,FNATIC,Team Vitality,Bind,3,13,2,1,0,3,10,0,4,FNATIC,Defense,0,FNATIC,-10,16,Team Vitality,2,10,-8
699,MIBR,LEVIATÁN,MIBR,LEVIATÁN,Ascent,9,13,6,3,0,7,6,0,1,LEVIATÁN,Defense,0,LEVIATÁN,-4,22,MIBR,6,6,0
699,LEVIATÁN,MIBR,MIBR,LEVIATÁN,Icebox,13,7,4,9,0,3,4,0,2,MIBR,Attack,0,LEVIATÁN,6,20,LEVIATÁN,9,3,6
700,NRG Esports,Sentinels,NRG Esports,Sentinels,Lotus,8,13,4,4,0,8,5,0,1,Sentinels,Attack,0,Sentinels,-5,21,NRG Esports,4,8,-4
700,Sentinels,NRG Esports,NRG Esports,Sentinels,Sunset,14,12,9,3,2,9,3,0,2,NRG Esports,Defense,1,Sentinels,2,26,Sentinels,9,3,6
701,FURIA,100 Thieves,FURIA,100 Thieves,Icebox,14,12,6,6,2,6,6,0,1,100 Thieves,Defense,1,FURIA,2,26,FURIA,6,6,0
701,100 Thieves,FURIA,FURIA,100 Thieves,Haven,14,16,9,3,2,9,3,4,2,FURIA,Attack,1,FURIA,-2,30,100 Thieves,3,9,-6
702,LOUD,Evil Geniuses,LOUD,Evil Geniuses,Lotus,13,7,7,6,0,6,1,0,1,Evil Geniuses,Attack,0,LOUD,6,20,LOUD,6,6,0
702,Evil Geniuses,LOUD,LOUD,Evil Geniuses,Sunset,13,6,6,7,0,0,6,0,2,LOUD,Defense,0,Evil Geniuses,7,19,Evil Geniuses,6,6,0
702,Evil Geniuses,LOUD,LOUD,Evil Geniuses,Icebox,13,11,6,7,0,5,6,0,3,LOUD,Attack,0,Evil Geniuses,2,24,,7,5,2
703,G2 Esports,Cloud9,G2 Esports,Cloud9,Ascent,13,11,4,9,0,3,8,0,1,Cloud9,Defense,0,G2 Esports,2,24,G2 Esports,4,8,-4
703,Cloud9,G2 Esports,G2 Esports,Cloud9,Icebox,13,5,10,3,0,3,2,0,2,G2 Esports,Defense,0,Cloud9,8,18,Cloud9,10,2,8
703,Cloud9,G2 Esports,G2 Esports,Cloud9,Lotus,8,13,0,8,0,4,9,0,3,G2 Esports,Attack,0,G2 Esports,-5,21,,8,4,4
704,FURIA,Evil Geniuses,FURIA,Evil Geniuses,Bind,5,13,2,3,0,9,4,0,1,Evil Geniuses,Attack,0,Evil Geniuses,-8,18,FURIA,3,9,-6
704,Evil Geniuses,FURIA,FURIA,Evil Geniuses,Lotus,13,4,3,10,0,2,2,0,2,FURIA,Attack,0,Evil Geniuses,9,17,Evil Geniuses,10,2,8
705,KRÜ Esports,Sentinels,KRÜ Esports,Sentinels,Lotus,11,13,7,4,0,8,5,0,1,Sentinels,Attack,0,Sentinels,-2,24,KRÜ Esports,4,8,-4
705,Sentinels,KRÜ Esports,KRÜ Esports,Sentinels,Split,13,10,8,5,0,6,4,0,2,KRÜ Esports,Defense,0,Sentinels,3,23,Sentinels,8,4,4
706,MIBR,LOUD,MIBR,LOUD,Ascent,7,13,4,3,0,5,8,0,1,LOUD,Defense,0,LOUD,-6,20,MIBR,4,8,-4
706,LOUD,MIBR,MIBR,LOUD,Lotus,11,13,6,5,0,7,6,0,2,MIBR,Attack,0,MIBR,-2,24,LOUD,5,7,-2
706,LOUD,MIBR,MIBR,LOUD,Sunset,13,9,7,6,0,6,3,0,3,MIBR,Attack,0,LOUD,4,22,,6,6,0
707,100 Thieves,LEVIATÁN,100 Thieves,LEVIATÁN,Bind,10,13,4,6,0,5,8,0,1,LEVIATÁN,Defense,0,LEVIATÁN,-3,23,100 Thieves,4,8,-4
707,LEVIATÁN,100 Thieves,100 Thieves,LEVIATÁN,Haven,13,4,3,10,0,2,2,0,2,100 Thieves,Attack,0,LEVIATÁN,9,17,LEVIATÁN,10,2,8
708,NRG Esports,G2 Esports,NRG Esports,G2 Esports,Haven,7,13,3,4,0,8,5,0,1,G2 Esports,Attack,0,G2 Esports,-6,20,NRG Esports,4,8,-4
708,G2 Esports,NRG Esports,NRG Esports,G2 Esports,Bind,13,8,9,4,0,5,3,0,2,NRG Esports,Defense,0,G2 Esports,5,21,G2 Esports,9,3,6
709,Cloud9,Sentinels,Cloud9,Sentinels,Haven,5,13,0,5,0,7,6,0,1,Sentinels,Attack,0,Sentinels,-8,18,Cloud9,5,7,-2
709,Sentinels,Cloud9,Cloud9,Sentinels,Split,13,8,6,7,0,2,6,0,2,Cloud9,Defense,0,Sentinels,5,21,Sentinels,6,6,0
710,LEVIATÁN,Evil Geniuses,LEVIATÁN,Evil Geniuses,Icebox,13,5,6,7,0,5,0,0,1,Evil Geniuses,Attack,0,LEVIATÁN,8,18,LEVIATÁN,7,5,2
710,Evil Geniuses,LEVIATÁN,LEVIATÁN,Evil Geniuses,Sunset,10,13,6,4,0,7,6,0,2,LEVIATÁN,Defense,0,LEVIATÁN,-3,23,Evil Geniuses,6,6,0
711,LOUD,FURIA,LOUD,FURIA,Haven,13,11,8,5,0,7,4,0,1,FURIA,Attack,0,LOUD,2,24,LOUD,5,7,-2
711,FURIA,LOUD,LOUD,FURIA,Icebox,13,10,6,7,0,5,5,0,2,LOUD,Attack,0,FURIA,3,23,FURIA,7,5,2
711,FURIA,LOUD,LOUD,FURIA,Bind,13,9,7,6,0,4,5,0,3,LOUD,Defense,0,FURIA,4,22,,7,5,2
712,100 Thieves,MIBR,100 Thieves,MIBR,Icebox,13,5,4,9,0,3,2,0,1,MIBR,Attack,0,100 Thieves,8,18,100 Thieves,9,3,6
712,MIBR,100 Thieves,100 Thieves,MIBR,Split,6,13,2,4,0,3,10,0,2,100 Thieves,Defense,0,100 Thieves,-7,19,MIBR,2,10,-8
713,KRÜ Esports,NRG Esports,KRÜ Esports,NRG Esports,Split,13,8,7,6,0,3,5,0,1,NRG Esports,Defense,0,KRÜ Esports,5,21,KRÜ Esports,7,5,2
713,NRG Esports,KRÜ Esports,KRÜ Esports,NRG Esports,Ascent,13,8,7,6,0,3,5,0,2,KRÜ Esports,Defense,0,NRG Esports,5,21,NRG Esports,7,5,2
713,NRG Esports,KRÜ Esports,KRÜ Esports,NRG Esports,Sunset,13,7,9,4,0,4,3,0,3,KRÜ Esports,Defense,0,NRG Esports,6,20,,9,3,6
714,KRÜ Esports,G2 Esports,KRÜ Esports,G2 Esports,Lotus,13,4,9,4,0,1,3,0,1,G2 Esports,Defense,0,KRÜ Esports,9,17,KRÜ Esports,9,3,6
714,G2 Esports,KRÜ Esports,KRÜ Esports,G2 Esports,Ascent,16,14,7,5,4,7,5,2,2,KRÜ Esports,Defense,1,G2 Esports,2,30,G2 Esports,7,5,2
714,G2 Esports,KRÜ Esports,KRÜ Esports,G2 Esports,Split,13,5,9,4,0,2,3,0,3,KRÜ Esports,Defense,0,G2 Esports,8,18,,9,3,6
715,LOUD,LEVIATÁN,LOUD,LEVIATÁN,Lotus,11,13,3,8,0,4,9,0,1,LEVIATÁN,Attack,0,LEVIATÁN,-2,24,LOUD,8,4,4
715,LEVIATÁN,LOUD,LOUD,LEVIATÁN,Icebox,13,6,5,8,0,4,2,0,2,LOUD,Attack,0,LEVIATÁN,7,19,LEVIATÁN,8,4,4
716,MIBR,FURIA,MIBR,FURIA,Sunset,10,13,6,4,0,7,6,0,1,FURIA,Defense,0,FURIA,-3,23,MIBR,6,6,0
716,FURIA,MIBR,MIBR,FURIA,Icebox,13,7,4,9,0,3,4,0,2,MIBR,Attack,0,FURIA,6,20,FURIA,9,3,6
717,NRG Esports,Cloud9,NRG Esports,Cloud9,Ascent,13,3,9,4,0,0,3,0,1,Cloud9,Defense,0,NRG Esports,10,16,NRG Esports,9,3,6
717,Cloud9,NRG Esports,NRG Esports,Cloud9,Icebox,13,10,8,5,0,7,3,0,2,NRG Esports,Attack,0,Cloud9,3,23,Cloud9,5,7,-2
717,Cloud9,NRG Esports,NRG Esports,Cloud9,Sunset,14,12,7,5,2,7,5,0,3,NRG Esports,Attack,1,Cloud9,2,26,,5,7,-2
718,Evil Geniuses,100 Thieves,Evil Geniuses,100 Thieves,Lotus,10,13,6,4,0,8,5,0,1,100 Thieves,Attack,0,100 Thieves,-3,23,Evil Geniuses,4,8,-4
718,100 Thieves,Evil Geniuses,Evil Geniuses,100 Thieves,Bind,10,13,6,4,0,8,5,0,2,Evil Geniuses,Attack,0,Evil Geniuses,-3,23,100 Thieves,4,8,-4
718,100 Thieves,Evil Geniuses,Evil Geniuses,100 Thieves,Ascent,13,7,9,4,0,4,3,0,3,Evil Geniuses,Defense,0,100 Thieves,6,20,,9,3,6
719,Cloud9,KRÜ Esports,Cloud9,KRÜ Esports,Icebox,7,13,2,5,0,7,6,0,1,KRÜ Esports,Attack,0,KRÜ Esports,-6,20,Cloud9,5,7,-2
719,KRÜ Esports,Cloud9,Cloud9,KRÜ Esports,Split,13,10,7,6,0,5,5,0,2,Cloud9,Defense,0,KRÜ Esports,3,23,KRÜ Esports,7,5,2
720,Evil Geniuses,MIBR,Evil Geniuses,MIBR,Bind,9,13,4,5,0,7,6,0,1,MIBR,Attack,0,MIBR,-4,22,Evil Geniuses,5,7,-2
720,MIBR,Evil Geniuses,Evil Geniuses,MIBR,Lotus,13,2,10,3,0,0,2,0,2,Evil Geniuses,Defense,0,MIBR,11,15,MIBR,10,2,8
721,LEVIATÁN,FURIA,LEVIATÁN,FURIA,Sunset,13,6,8,5,0,2,4,0,1,FURIA,Defense,0,LEVIATÁN,7,19,LEVIATÁN,8,4,4
721,FURIA,LEVIATÁN,LEVIATÁN,FURIA,Icebox,6,13,5,1,0,6,7,0,2,LEVIATÁN,Defense,0,LEVIATÁN,-7,19,FURIA,5,7,-2
722,LOUD,100 Thieves,LOUD,100 Thieves,Ascent,1,13,1,0,0,2,11,0,1,100 Thieves,Defense,0,100 Thieves,-12,14,LOUD,1,11,-10
722,100 Thieves,LOUD,LOUD,100 Thieves,Bind,8,13,2,6,0,6,7,0,2,LOUD,Attack,0,LOUD,-5,21,100 Thieves,6,6,0
722,100 Thieves,LOUD,LOUD,100 Thieves,Lotus,10,13,5,5,0,6,7,0,3,LOUD,Defense,0,LOUD,-3,23,,5,7,-2
723,G2 Esports,Sentinels,G2 Esports,Sentinels,Bind,13,6,7,6,0,6,0,0,1,Sentinels,Attack,0,G2 Esports,7,19,G2 Esports,6,6,0
723,Sentinels,G2 Esports,G2 Esports,Sentinels,Lotus,9,13,4,5,0,5,8,0,2,G2 Esports,Defense,0,G2 Esports,-4,22,Sentinels,4,8,-4
724,Cloud9,KRÜ Esports,Cloud9,KRÜ Esports,Abyss,11,13,5,6,0,6,7,0,1,KRÜ Esports,Attack,0,KRÜ Esports,-2,24,Cloud9,6,6,0
724,KRÜ Esports,Cloud9,Cloud9,KRÜ Esports,Lotus,11,13,10,1,0,11,2,0,2,Cloud9,Attack,0,Cloud9,-2,24,KRÜ Esports,1,11,-10
724,KRÜ Esports,Cloud9,Cloud9,KRÜ Esports,Haven,13,6,4,9,0,3,3,0,3,Cloud9,Attack,0,KRÜ Esports,7,19,,9,3,6
725,Sentinels,100 Thieves,Sentinels,100 Thieves,Haven,7,13,4,3,0,9,4,0,1,100 Thieves,Attack,0,100 Thieves,-6,20,Sentinels,3,9,-6
725,100 Thieves,Sentinels,Sentinels,100 Thieves,Ascent,13,10,8,5,0,6,4,0,2,Sentinels,Defense,0,100 Thieves,3,23,100 Thieves,8,4,4
726,LEVIATÁN,KRÜ Esports,LEVIATÁN,KRÜ Esports,Icebox,13,2,3,10,0,2,0,0,1,KRÜ Esports,Attack,0,LEVIATÁN,11,15,LEVIATÁN,10,2,8
726,KRÜ Esports,LEVIATÁN,LEVIATÁN,KRÜ Esports,Sunset,4,13,2,2,0,3,10,0,2,LEVIATÁN,Defense,0,LEVIATÁN,-9,17,KRÜ Esports,2,10,-8
727,G2 Esports,100 Thieves,G2 Esports,100 Thieves,Lotus,13,5,6,7,0,5,0,0,1,100 Thieves,Attack,0,G2 Esports,8,18,G2 Esports,7,5,2
727,100 Thieves,G2 Esports,G2 Esports,100 Thieves,Abyss,10,13,5,5,0,6,7,0,2,G2 Esports,Defense,0,G2 Esports,-3,23,100 Thieves,5,7,-2
728,LEVIATÁN,G2 Esports,LEVIATÁN,G2 Esports,Icebox,8,13,6,2,0,10,3,0,1,G2 Esports,Attack,0,G2 Esports,-5,21,LEVIATÁN,2,10,-8
728,G2 Esports,LEVIATÁN,LEVIATÁN,G2 Esports,Bind,13,6,8,5,0,2,4,0,2,LEVIATÁN,Defense,0,G2 Esports,7,19,G2 Esports,8,4,4
729,100 Thieves,KRÜ Esports,100 Thieves,KRÜ Esports,Icebox,13,9,6,7,0,3,6,0,1,KRÜ Esports,Defense,0,100 Thieves,4,22,100 Thieves,6,6,0
729,KRÜ Esports,100 Thieves,100 Thieves,KRÜ Esports,Lotus,13,11,7,6,0,6,5,0,2,100 Thieves,Attack,0,KRÜ Esports,2,24,KRÜ Esports,6,6,0
729,KRÜ Esports,100 Thieves,100 Thieves,KRÜ Esports,Ascent,13,11,5,8,0,4,7,0,3,100 Thieves,Defense,0,KRÜ Esports,2,24,,5,7,-2
730,LEVIATÁN,KRÜ Esports,LEVIATÁN,KRÜ Esports,Icebox,13,3,11,2,0,2,1,0,1,KRÜ Esports,Defense,0,LEVIATÁN,10,16,LEVIATÁN,11,1,10
730,KRÜ Esports,LEVIATÁN,LEVIATÁN,KRÜ Esports,Haven,13,11,5,8,0,4,7,0,2,LEVIATÁN,Defense,0,KRÜ Esports,2,24,KRÜ Esports,5,7,-2
730,LEVIATÁN,KRÜ Esports,LEVIATÁN,KRÜ Esports,Sunset,7,13,4,3,0,9,4,0,3,KRÜ Esports,Attack,0,KRÜ Esports,-6,20,LEVIATÁN,3,9,-6
730,KRÜ Esports,LEVIATÁN,LEVIATÁN,KRÜ Esports,Abyss,10,13,4,6,0,5,8,0,4,LEVIATÁN,Defense,0,LEVIATÁN,-3,23,KRÜ Esports,4,8,-4
730,LEVIATÁN,KRÜ Esports,LEVIATÁN,KRÜ Esports,Ascent,13,10,8,5,0,6,4,0,5,KRÜ Esports,Defense,0,LEVIATÁN,3,23,,8,4,4
731,G2 Esports,LEVIATÁN,G2 Esports,LEVIATÁN,Lotus,13,15,6,6,1,6,6,3,1,LEVIATÁN,Attack,1,LEVIATÁN,-2,28,G2 Esports,6,6,0
731,LEVIATÁN,G2 Esports,G2 Esports,LEVIATÁN,Haven,16,14,5,7,4,5,7,2,2,G2 Esports,Attack,1,LEVIATÁN,2,30,LEVIATÁN,7,5,2
731,G2 Esports,LEVIATÁN,G2 Esports,LEVIATÁN,Bind,13,9,4,9,0,1,8,0,3,LEVIATÁN,Defense,0,G2 Esports,4,22,G2 Esports,4,8,-4
731,LEVIATÁN,G2 Esports,G2 Esports,LEVIATÁN,Ascent,13,4,8,5,0,0,4,0,4,G2 Esports,Defense,0,LEVIATÁN,9,17,LEVIATÁN,8,4,4
732,Sentinels,Gen.G,Sentinels,Gen.G,Haven,8,13,5,3,0,6,7,0,1,Gen.G,Defense,0,Gen.G,-5,21,Sentinels,5,7,-2
732,Gen.G,Sentinels,Sentinels,Gen.G,Ascent,13,7,8,5,0,3,4,0,2,Sentinels,Defense,0,Gen.G,6,20,Gen.G,8,4,4
733,FunPlus Phoenix,Team Heretics,FunPlus Phoenix,Team Heretics,Abyss,12,14,8,4,0,8,4,2,1,Team Heretics,Defense,1,Team Heretics,-2,26,FunPlus Phoenix,8,4,4
733,Team Heretics,FunPlus Phoenix,FunPlus Phoenix,Team Heretics,Bind,9,13,4,5,0,5,8,0,2,FunPlus Phoenix,Defense,0,FunPlus Phoenix,-4,22,Team Heretics,4,8,-4
733,Team Heretics,FunPlus Phoenix,FunPlus Phoenix,Team Heretics,Lotus,15,13,6,6,3,6,6,1,3,FunPlus Phoenix,Attack,1,Team Heretics,2,28,,6,6,0
734,KRÜ Esports,DRX,KRÜ Esports,DRX,Haven,13,2,3,10,0,2,0,0,1,DRX,Attack,0,KRÜ Esports,11,15,KRÜ Esports,10,2,8
734,DRX,KRÜ Esports,KRÜ Esports,DRX,Abyss,13,6,5,8,0,4,2,0,2,KRÜ Esports,Attack,0,DRX,7,19,DRX,8,4,4
734,DRX,KRÜ Esports,KRÜ Esports,DRX,Bind,13,6,4,9,0,3,3,0,3,KRÜ Esports,Attack,0,DRX,7,19,,9,3,6
735,Bilibili Gaming,FNATIC,Bilibili Gaming,FNATIC,Bind,9,13,5,4,0,6,7,0,1,FNATIC,Defense,0,FNATIC,-4,22,Bilibili Gaming,5,7,-2
735,FNATIC,Bilibili Gaming,Bilibili Gaming,FNATIC,Lotus,13,4,3,10,0,2,2,0,2,Bilibili Gaming,Attack,0,FNATIC,9,17,FNATIC,10,2,8
736,TALON,LEVIATÁN,TALON,LEVIATÁN,Bind,11,13,5,6,0,6,7,0,1,LEVIATÁN,Defense,0,LEVIATÁN,-2,24,TALON,5,7,-2
736,LEVIATÁN,TALON,TALON,LEVIATÁN,Ascent,13,8,5,8,0,4,4,0,2,TALON,Attack,0,LEVIATÁN,5,21,LEVIATÁN,8,4,4
737,Trace Esports,Team Vitality,Trace Esports,Team Vitality,Ascent,15,13,7,5,3,7,5,1,1,Team Vitality,Defense,1,Trace Esports,2,28,Trace Esports,7,5,2
737,Team Vitality,Trace Esports,Trace Esports,Team Vitality,Sunset,13,7,5,8,0,4,3,0,2,Trace Esports,Attack,0,Team Vitality,6,20,Team Vitality,8,4,4
737,Team Vitality,Trace Esports,Trace Esports,Team Vitality,Bind,7,13,6,1,0,7,6,0,3,Trace Esports,Defense,0,Trace Esports,-6,20,,6,6,0
738,Paper Rex,G2 Esports,Paper Rex,G2 Esports,Icebox,8,13,4,4,0,8,5,0,1,G2 Esports,Attack,0,G2 Esports,-5,21,Paper Rex,4,8,-4
738,G2 Esports,Paper Rex,Paper Rex,G2 Esports,Lotus,13,9,4,9,0,3,6,0,2,Paper Rex,Attack,0,G2 Esports,4,22,G2 Esports,9,3,6
739,FUT Esports,EDward Gaming,FUT Esports,EDward Gaming,Lotus,9,13,5,4,0,8,5,0,1,EDward Gaming,Attack,0,EDward Gaming,-4,22,FUT Esports,4,8,-4
739,EDward Gaming,FUT Esports,FUT Esports,EDward Gaming,Bind,13,10,8,5,0,6,4,0,2,FUT Esports,Defense,0,EDward Gaming,3,23,EDward Gaming,8,4,4
740,Team Heretics,Gen.G,Team Heretics,Gen.G,Abyss,11,13,6,5,0,7,6,0,1,Gen.G,Attack,0,Gen.G,-2,24,Team Heretics,5,7,-2
740,Gen.G,Team Heretics,Team Heretics,Gen.G,Lotus,11,13,8,3,0,9,4,0,2,Team Heretics,Defense,0,Team Heretics,-2,24,Gen.G,8,4,4
740,Gen.G,Team Heretics,Team Heretics,Gen.G,Bind,10,13,6,4,0,8,5,0,3,Team Heretics,Attack,0,Team Heretics,-3,23,,4,8,-4
741,DRX,FNATIC,DRX,FNATIC,Abyss,13,11,6,7,0,5,6,0,1,FNATIC,Attack,0,DRX,2,24,DRX,7,5,2
741,FNATIC,DRX,DRX,FNATIC,Lotus,6,13,1,5,0,7,6,0,2,DRX,Attack,0,DRX,-7,19,FNATIC,5,7,-2
742,Trace Esports,LEVIATÁN,Trace Esports,LEVIATÁN,Bind,13,10,7,6,0,5,5,0,1,LEVIATÁN,Defense,0,Trace Esports,3,23,Trace Esports,7,5,2
742,LEVIATÁN,Trace Esports,Trace Esports,LEVIATÁN,Sunset,13,9,6,7,0,5,4,0,2,Trace Esports,Attack,0,LEVIATÁN,4,22,LEVIATÁN,7,5,2
742,LEVIATÁN,Trace Esports,Trace Esports,LEVIATÁN,Ascent,5,13,2,3,0,3,10,0,3,Trace Esports,Defense,0,Trace Esports,-8,18,,2,10,-8
743,G2 Esports,EDward Gaming,G2 Esports,EDward Gaming,Icebox,8,13,5,3,0,9,4,0,1,EDward Gaming,Attack,0,EDward Gaming,-5,21,G2 Esports,3,9,-6
743,EDward Gaming,G2 Esports,G2 Esports,EDward Gaming,Haven,11,13,5,6,0,6,7,0,2,G2 Esports,Attack,0,G2 Esports,-2,24,EDward Gaming,6,6,0
743,EDward Gaming,G2 Esports,G2 Esports,EDward Gaming,Bind,11,13,8,3,0,9,4,0,3,G2 Esports,Attack,0,G2 Esports,-2,24,,3,9,-6
744,FunPlus Phoenix,Sentinels,FunPlus Phoenix,Sentinels,Bind,8,13,0,8,0,4,9,0,1,Sentinels,Attack,0,Sentinels,-5,21,FunPlus Phoenix,8,4,4
744,Sentinels,FunPlus Phoenix,FunPlus Phoenix,Sentinels,Lotus,13,5,4,9,0,3,2,0,2,FunPlus Phoenix,Attack,0,Sentinels,8,18,Sentinels,9,3,6
745,KRÜ Esports,Bilibili Gaming,KRÜ Esports,Bilibili Gaming,Lotus,13,9,8,5,0,7,2,0,1,Bilibili Gaming,Attack,0,KRÜ Esports,4,22,KRÜ Esports,5,7,-2
745,Bilibili Gaming,KRÜ Esports,KRÜ Esports,Bilibili Gaming,Icebox,4,13,3,1,0,4,9,0,2,KRÜ Esports,Defense,0,KRÜ Esports,-9,17,Bilibili Gaming,3,9,-6
746,TALON,Team Vitality,TALON,Team Vitality,Lotus,6,13,4,2,0,10,3,0,1,Team Vitality,Attack,0,Team Vitality,-7,19,TALON,2,10,-8
746,Team Vitality,TALON,TALON,Team Vitality,Sunset,13,8,6,7,0,2,6,0,2,TALON,Defense,0,Team Vitality,5,21,Team Vitality,6,6,0
747,FUT Esports,Paper Rex,FUT Esports,Paper Rex,Sunset,11,13,6,5,0,7,6,0,1,Paper Rex,Attack,0,Paper Rex,-2,24,FUT Esports,5,7,-2
747,Paper Rex,FUT Esports,FUT Esports,Paper Rex,Bind,13,6,4,9,0,3,3,0,2,FUT Esports,Attack,0,Paper Rex,7,19,Paper Rex,9,3,6
748,Sentinels,Gen.G,Sentinels,Gen.G,Lotus,13,9,7,6,0,4,5,0,1,Gen.G,Defense,0,Sentinels,4,22,Sentinels,7,5,2
748,Gen.G,Sentinels,Sentinels,Gen.G,Icebox,6,13,5,1,0,6,7,0,2,Sentinels,Defense,0,Sentinels,-7,19,Gen.G,5,7,-2
749,KRÜ Esports,FNATIC,KRÜ Esports,FNATIC,Sunset,13,11,8,5,0,7,4,0,1,FNATIC,Defense,0,KRÜ Esports,2,24,KRÜ Esports,8,4,4
749,FNATIC,KRÜ Esports,KRÜ Esports,FNATIC,Haven,13,9,7,6,0,6,3,0,2,KRÜ Esports,Attack,0,FNATIC,4,22,FNATIC,6,6,0
749,FNATIC,KRÜ Esports,KRÜ Esports,FNATIC,Lotus,13,5,5,8,0,4,1,0,3,KRÜ Esports,Attack,0,FNATIC,8,18,,8,4,4
750,LEVIATÁN,Team Vitality,LEVIATÁN,Team Vitality,Icebox,14,12,5,7,2,5,7,0,1,Team Vitality,Attack,1,LEVIATÁN,2,26,LEVIATÁN,7,5,2
750,Team Vitality,LEVIATÁN,LEVIATÁN,Team Vitality,Sunset,4,13,2,2,0,3,10,0,2,LEVIATÁN,Defense,0,LEVIATÁN,-9,17,Team Vitality,2,10,-8
751,EDward Gaming,Paper Rex,EDward Gaming,Paper Rex,Icebox,3,13,0,3,0,9,4,0,1,Paper Rex,Attack,0,Paper Rex,-10,16,EDward Gaming,3,9,-6
751,Paper Rex,EDward Gaming,EDward Gaming,Paper Rex,Sunset,8,13,2,6,0,6,7,0,2,EDward Gaming,Attack,0,EDward Gaming,-5,21,Paper Rex,6,6,0
751,Paper Rex,EDward Gaming,EDward Gaming,Paper Rex,Lotus,4,13,1,3,0,9,4,0,3,EDward Gaming,Attack,0,EDward Gaming,-9,17,,3,9,-6
752,Sentinels,DRX,Sentinels,DRX,Sunset,15,13,6,6,3,6,6,1,1,DRX,Attack,1,Sentinels,2,28,Sentinels,6,6,0
752,DRX,Sentinels,Sentinels,DRX,Haven,8,13,2,6,0,6,7,0,2,Sentinels,Attack,0,Sentinels,-5,21,DRX,6,6,0
753,Trace Esports,EDward Gaming,Trace Esports,EDward Gaming,Bind,7,13,5,2,0,10,3,0,1,EDward Gaming,Attack,0,EDward Gaming,-6,20,Trace Esports,2,10,-8
753,EDward Gaming,Trace Esports,Trace Esports,EDward Gaming,Sunset,13,10,3,10,0,2,8,0,2,Trace Esports,Attack,0,EDward Gaming,3,23,EDward Gaming,10,2,8
754,LEVIATÁN,G2 Esports,LEVIATÁN,G2 Esports,Icebox,16,14,8,4,4,8,4,2,1,G2 Esports,Attack,1,LEVIATÁN,2,30,LEVIATÁN,4,8,-4
754,G2 Esports,LEVIATÁN,LEVIATÁN,G2 Esports,Abyss,5,13,4,1,0,5,8,0,2,LEVIATÁN,Defense,0,LEVIATÁN,-8,18,G2 Esports,4,8,-4
755,FNATIC,Team Heretics,FNATIC,Team Heretics,Lotus,3,13,3,0,0,4,9,0,1,Team Heretics,Defense,0,Team Heretics,-10,16,FNATIC,3,9,-6
755,Team Heretics,FNATIC,FNATIC,Team Heretics,Abyss,14,12,9,3,2,9,3,0,2,FNATIC,Defense,1,Team Heretics,2,26,Team Heretics,9,3,6
756,Trace Esports,DRX,Trace Esports,DRX,Lotus,3,13,1,2,0,10,3,0,1,DRX,Attack,0,DRX,-10,16,Trace Esports,2,10,-8
756,DRX,Trace Esports,Trace Esports,DRX,Abyss,13,5,4,9,0,3,2,0,2,Trace Esports,Attack,0,DRX,8,18,DRX,9,3,6
757,FNATIC,G2 Esports,FNATIC,G2 Esports,Haven,13,3,4,9,0,3,0,0,1,G2 Esports,Attack,0,FNATIC,10,16,FNATIC,9,3,6
757,G2 Esports,FNATIC,FNATIC,G2 Esports,Bind,11,13,7,4,0,8,5,0,2,FNATIC,Attack,0,FNATIC,-2,24,G2 Esports,4,8,-4
758,EDward Gaming,Sentinels,EDward Gaming,Sentinels,Haven,9,13,5,4,0,8,5,0,1,Sentinels,Attack,0,Sentinels,-4,22,EDward Gaming,4,8,-4
758,Sentinels,EDward Gaming,EDward Gaming,Sentinels,Lotus,9,13,3,6,0,6,7,0,2,EDward Gaming,Attack,0,EDward Gaming,-4,22,Sentinels,6,6,0
758,Sentinels,EDward Gaming,EDward Gaming,Sentinels,Sunset,6,13,4,2,0,10,3,0,3,EDward Gaming,Attack,0,EDward Gaming,-7,19,,2,10,-8
759,LEVIATÁN,Team Heretics,LEVIATÁN,Team Heretics,Icebox,15,13,7,5,3,7,5,1,1,Team Heretics,Defense,1,LEVIATÁN,2,28,LEVIATÁN,7,5,2
759,Team Heretics,LEVIATÁN,LEVIATÁN,Team Heretics,Lotus,10,13,8,2,0,9,4,0,2,LEVIATÁN,Defense,0,LEVIATÁN,-3,23,Team Heretics,8,4,4
760,Sentinels,FNATIC,Sentinels,FNATIC,Sunset,13,11,9,4,0,8,3,0,1,FNATIC,Attack,0,Sentinels,2,24,Sentinels,4,8,-4
760,FNATIC,Sentinels,Sentinels,FNATIC,Bind,13,9,8,5,0,7,2,0,2,Sentinels,Attack,0,FNATIC,4,22,FNATIC,5,7,-2
760,FNATIC,Sentinels,Sentinels,FNATIC,Lotus,6,13,2,4,0,8,5,0,3,Sentinels,Attack,0,Sentinels,-7,19,,4,8,-4
761,DRX,Team Heretics,DRX,Team Heretics,Abyss,13,5,7,6,0,0,5,0,1,Team Heretics,Defense,0,DRX,8,18,DRX,7,5,2
761,Team Heretics,DRX,DRX,Team Heretics,Sunset,13,5,6,7,0,5,0,0,2,DRX,Attack,0,Team Heretics,8,18,Team Heretics,7,5,2
761,Team Heretics,DRX,DRX,Team Heretics,Icebox,13,10,8,5,0,7,3,0,3,DRX,Attack,0,Team Heretics,3,23,,5,7,-2
762,LEVIATÁN,EDward Gaming,LEVIATÁN,EDward Gaming,Icebox,16,14,3,9,4,3,9,2,1,EDward Gaming,Attack,1,LEVIATÁN,2,30,LEVIATÁN,9,3,6
762,EDward Gaming,LEVIATÁN,LEVIATÁN,EDward Gaming,Lotus,13,4,8,5,0,0,4,0,2,LEVIATÁN,Defense,0,EDward Gaming,9,17,EDward Gaming,8,4,4
762,EDward Gaming,LEVIATÁN,LEVIATÁN,EDward Gaming,Abyss,13,11,6,7,0,5,6,0,3,LEVIATÁN,Defense,0,EDward Gaming,2,24,,6,6,0
763,Sentinels,Team Heretics,Sentinels,Team Heretics,Haven,13,8,6,7,0,5,3,0,1,Team Heretics,Attack,0,Sentinels,5,21,Sentinels,7,5,2
763,Team Heretics,Sentinels,Sentinels,Team Heretics,Icebox,13,9,5,8,0,2,7,0,2,Sentinels,Defense,0,Team Heretics,4,22,Team Heretics,5,7,-2
763,Team Heretics,Sentinels,Sentinels,Team Heretics,Abyss,13,7,5,8,0,4,3,0,3,Sentinels,Attack,0,Team Heretics,6,20,,8,4,4
764,LEVIATÁN,Team Heretics,LEVIATÁN,Team Heretics,Icebox,7,13,5,2,0,6,7,0,1,Team Heretics,Defense,0,Team Heretics,-6,20,LEVIATÁN,5,7,-2
764,Team Heretics,LEVIATÁN,LEVIATÁN,Team Heretics,Sunset,15,13,8,4,3,8,4,1,2,LEVIATÁN,Defense,1,Team Heretics,2,28,Team Heretics,8,4,4
764,LEVIATÁN,Team Heretics,LEVIATÁN,Team Heretics,Abyss,13,9,5,8,0,2,7,0,3,Team Heretics,Defense,0,LEVIATÁN,4,22,LEVIATÁN,5,7,-2
764,Team Heretics,LEVIATÁN,LEVIATÁN,Team Heretics,Lotus,13,3,11,2,0,2,1,0,4,LEVIATÁN,Defense,0,Team Heretics,10,16,Team Heretics,11,1,10
765,EDward Gaming,Team Heretics,EDward Gaming,Team Heretics,Haven,6,13,3,3,0,4,9,0,1,Team Heretics,Defense,0,Team Heretics,-7,19,EDward Gaming,3,9,-6
765,Team Heretics,EDward Gaming,EDward Gaming,Team Heretics,Sunset,4,13,3,1,0,11,2,0,2,EDward Gaming,Attack,0,EDward Gaming,-9,17,Team Heretics,1,11,-10
765,EDward Gaming,Team Heretics,EDward Gaming,Team Heretics,Lotus,13,9,7,6,0,6,3,0,3,Team Heretics,Attack,0,EDward Gaming,4,22,EDward Gaming,6,6,0
765,Team Heretics,EDward Gaming,EDward Gaming,Team Heretics,Bind,13,11,7,6,0,6,5,0,4,EDward Gaming,Attack,0,Team Heretics,2,24,Team Heretics,6,6,0
765,EDward Gaming,Team Heretics,EDward Gaming,Team Heretics,Abyss,13,9,8,5,0,5,4,0,5,Team Heretics,Defense,0,EDward Gaming,4,22,,8,4,4
